K_ENTIDAD_MUNICIPIO,K_ENTIDAD,K_MUNICIPIO,ANIO,MES,CABLE_COAXIAL,DSL,FIBRA_OPTICA,SATELITAL,TERRESTRE_FIJO_INALAMBRICO,OTRAS_TECNOLOGIAS,SIN_TECNOLOGIA_ESPECIFICADA,ALL_ACCESS,COAX_FO,NUM_OPS
01001,01,001,2019,06,58308,66830,54299,0,0,0,0,179437,112607,3
01002,01,002,2019,06,0,1075,1,0,0,0,0,1076,1,2
01003,01,003,2019,06,0,4373,1,0,0,0,0,4374,1,2
01004,01,004,2019,06,0,491,0,0,0,0,0,491,0,1
01005,01,005,2019,06,0,5914,259,0,0,0,0,6173,259,2
01006,01,006,2019,06,0,2640,0,0,0,0,0,2640,0,1
01007,01,007,2019,06,0,2586,2,0,0,0,0,2588,2,2
01008,01,008,2019,06,0,509,0,0,0,0,0,509,0,1
01009,01,009,2019,06,0,361,0,0,0,0,0,361,0,1
01010,01,010,2019,06,0,298,0,0,0,0,0,298,0,1
01011,01,011,2019,06,0,1730,139,0,0,0,0,1869,139,2
02001,02,001,2019,06,50324,45906,12651,0,0,0,0,108881,62975,3
02002,02,002,2019,06,109717,105591,18103,0,0,0,0,233411,127820,4
02003,02,003,2019,06,12037,8020,2710,0,0,0,0,22767,14747,3
02004,02,004,2019,06,198445,121273,132746,0,0,0,0,452464,331191,3
02005,02,005,2019,06,17122,9421,1481,0,0,0,0,28024,18603,3
03001,03,001,2019,06,3536,6744,61,0,0,0,0,10341,3597,2
03002,03,002,2019,06,0,7654,310,0,0,0,0,7964,310,1
03003,03,003,2019,06,19169,23787,23731,0,0,0,0,66687,42900,3
03008,03,008,2019,06,21673,23737,30199,0,0,0,0,75609,51872,3
03009,03,009,2019,06,0,3070,0,0,0,0,0,3070,0,1
04001,04,001,2019,06,0,1894,21,0,0,0,0,1915,21,1
04002,04,002,2019,06,0,18488,1263,0,0,0,0,19751,1263,2
04003,04,003,2019,06,15418,18632,5770,0,0,0,0,39820,21188,3
04004,04,004,2019,06,747,2414,683,0,0,0,0,3844,1430,2
04005,04,005,2019,06,0,551,8,0,0,0,0,559,8,2
04006,04,006,2019,06,0,219,0,0,0,0,0,219,0,1
04007,04,007,2019,06,0,266,0,0,0,0,0,266,0,1
04008,04,008,2019,06,0,72,0,0,0,0,0,72,0,1
04009,04,009,2019,06,0,2358,13,0,0,0,0,2371,13,1
04010,04,010,2019,06,0,205,0,0,0,0,0,205,0,1
04011,04,011,2019,06,0,694,0,0,0,0,0,694,0,1
05002,05,002,2019,06,0,9657,4505,0,0,0,0,14162,4505,1
05003,05,003,2019,06,0,3436,0,0,0,0,0,3436,0,1
05004,05,004,2019,06,0,926,1,0,0,0,0,927,1,2
05005,05,005,2019,06,0,64,0,0,0,0,0,64,0,1
05006,05,006,2019,06,0,2761,0,0,0,0,0,2761,0,1
05007,05,007,2019,06,0,1057,0,0,0,0,0,1057,0,1
05008,05,008,2019,06,0,71,0,0,0,0,0,71,0,1
05009,05,009,2019,06,3321,1964,0,0,0,0,0,5285,3321,2
05010,05,010,2019,06,2682,11208,361,0,0,0,0,14251,3043,2
05011,05,011,2019,06,0,392,0,0,0,0,0,392,0,1
05012,05,012,2019,06,0,93,0,0,0,0,0,93,0,1
05014,05,014,2019,06,0,236,0,0,0,0,0,236,0,1
05016,05,016,2019,06,0,33,0,0,0,0,0,33,0,1
05017,05,017,2019,06,5614,2544,41,0,0,0,0,8199,5655,2
05018,05,018,2019,06,12365,24182,4677,0,0,0,0,41224,17042,3
05019,05,019,2019,06,0,1176,0,0,0,0,0,1176,0,1
05020,05,020,2019,06,0,7741,222,0,0,0,0,7963,222,1
05021,05,021,2019,06,0,333,0,0,0,0,0,333,0,1
05022,05,022,2019,06,0,2583,82,0,0,0,0,2665,82,1
05023,05,023,2019,06,0,556,0,0,0,0,0,556,0,1
05024,05,024,2019,06,0,3871,336,0,0,0,0,4207,336,1
05025,05,025,2019,06,0,15776,6438,0,0,0,0,22214,6438,1
05026,05,026,2019,06,0,218,0,0,0,0,0,218,0,1
05027,05,027,2019,06,0,4332,175,0,0,0,0,4507,175,1
05028,05,028,2019,06,0,8945,3408,0,0,0,0,12353,3408,1
05029,05,029,2019,06,0,46,0,0,0,0,0,46,0,1
05030,05,030,2019,06,0,64783,30554,0,0,0,0,95337,30554,2
05031,05,031,2019,06,0,2406,14,0,0,0,0,2420,14,1
05032,05,032,2019,06,0,6085,738,0,0,0,0,6823,738,1
05033,05,033,2019,06,5954,2494,41,0,0,0,0,8489,5995,2
05034,05,034,2019,06,0,1,2,0,0,0,0,3,2,2
05035,05,035,2019,06,78690,48099,20839,0,0,0,0,147628,99529,3
05036,05,036,2019,06,0,142,0,0,0,0,0,142,0,1
05037,05,037,2019,06,0,532,0,0,0,0,0,532,0,1
05038,05,038,2019,06,0,1452,110,0,0,0,0,1562,110,1
06001,06,001,2019,06,0,2277,1,0,0,0,0,2278,1,1
06002,06,002,2019,06,47696,19389,4664,0,0,0,0,71749,52360,3
06003,06,003,2019,06,0,1304,0,0,0,0,0,1304,0,1
06004,06,004,2019,06,0,974,0,0,0,0,0,974,0,1
06005,06,005,2019,06,570,1961,1,0,0,0,0,2532,571,2
06006,06,006,2019,06,0,277,0,0,0,0,0,277,0,1
06007,06,007,2019,06,13627,20838,4118,0,0,0,0,38583,17745,3
06008,06,008,2019,06,0,627,0,0,0,0,0,627,0,1
06009,06,009,2019,06,0,10738,513,0,0,0,0,11251,513,1
06010,06,010,2019,06,0,11981,1125,0,0,0,0,13106,1125,2
07001,07,001,2019,06,0,176,0,0,0,0,0,176,0,1
07002,07,002,2019,06,0,383,0,0,0,0,0,383,0,1
07003,07,003,2019,06,0,436,0,0,0,0,0,436,0,1
07004,07,004,2019,06,0,101,0,0,0,0,0,101,0,1
07008,07,008,2019,06,0,640,0,0,0,0,0,640,0,1
07009,07,009,2019,06,1814,1497,4,0,0,0,0,3315,1818,2
07012,07,012,2019,06,4641,665,3,0,0,0,0,5309,4644,2
07013,07,013,2019,06,0,844,12,0,0,0,0,856,12,1
07015,07,015,2019,06,0,722,0,0,0,0,0,722,0,1
07016,07,016,2019,06,0,323,0,0,0,0,0,323,0,1
07017,07,017,2019,06,2467,2580,10,0,0,0,0,5057,2477,2
07019,07,019,2019,06,4705,9244,323,0,0,0,0,14272,5028,2
07020,07,020,2019,06,0,366,0,0,0,0,0,366,0,1
07021,07,021,2019,06,0,334,0,0,0,0,0,334,0,1
07023,07,023,2019,06,0,44,0,0,0,0,0,44,0,1
07027,07,027,2019,06,3454,1320,68,0,0,0,0,4842,3522,2
07029,07,029,2019,06,0,20,0,0,0,0,0,20,0,1
07030,07,030,2019,06,0,107,0,0,0,0,0,107,0,1
07031,07,031,2019,06,0,253,0,0,0,0,0,253,0,1
07032,07,032,2019,06,0,519,0,0,0,0,0,519,0,1
07034,07,034,2019,06,0,1637,27,0,0,0,0,1664,27,1
07035,07,035,2019,06,0,0,1,0,0,0,0,1,1,1
07037,07,037,2019,06,0,560,224,0,0,0,0,784,224,1
07040,07,040,2019,06,2338,1777,8,0,0,0,0,4123,2346,2
07044,07,044,2019,06,0,262,0,0,0,0,0,262,0,1
07046,07,046,2019,06,0,635,0,0,0,0,0,635,0,1
07048,07,048,2019,06,0,349,0,0,0,0,0,349,0,1
07049,07,049,2019,06,0,4,0,0,0,0,0,4,0,1
07050,07,050,2019,06,0,106,0,0,0,0,0,106,0,1
07051,07,051,2019,06,0,1055,15,0,0,0,0,1070,15,1
07052,07,052,2019,06,0,782,8,0,0,0,0,790,8,1
07054,07,054,2019,06,0,342,1,0,0,0,0,343,1,2
07055,07,055,2019,06,0,190,0,0,0,0,0,190,0,1
07057,07,057,2019,06,0,1149,0,0,0,0,0,1149,0,1
07059,07,059,2019,06,0,2223,28,0,0,0,0,2251,28,1
07061,07,061,2019,06,1436,1912,17,0,0,0,0,3365,1453,2
07063,07,063,2019,06,0,21,0,0,0,0,0,21,0,1
07064,07,064,2019,06,0,176,0,0,0,0,0,176,0,1
07065,07,065,2019,06,0,2852,151,0,0,0,0,3003,151,1
07068,07,068,2019,06,0,1046,25,0,0,0,0,1071,25,2
07069,07,069,2019,06,0,1027,18,0,0,0,0,1045,18,2
07071,07,071,2019,06,356,240,0,0,0,0,0,596,356,2
07072,07,072,2019,06,0,401,0,0,0,0,0,401,0,1
07074,07,074,2019,06,0,2142,17,0,0,0,0,2159,17,1
07075,07,075,2019,06,0,397,0,0,0,0,0,397,0,1
07077,07,077,2019,06,0,123,0,0,0,0,0,123,0,1
07078,07,078,2019,06,6318,15081,576,0,0,0,0,21975,6894,2
07079,07,079,2019,06,0,1343,2,0,0,0,0,1345,2,2
07081,07,081,2019,06,0,434,0,0,0,0,0,434,0,1
07084,07,084,2019,06,0,9,0,0,0,0,0,9,0,1
07085,07,085,2019,06,0,25,0,0,0,0,0,25,0,1
07086,07,086,2019,06,0,533,38,0,0,0,0,571,38,2
07087,07,087,2019,06,0,995,56,0,0,0,0,1051,56,2
07089,07,089,2019,06,10275,18014,6404,0,0,0,0,34693,16679,3
07091,07,091,2019,06,0,140,0,0,0,0,0,140,0,1
07092,07,092,2019,06,0,274,0,0,0,0,0,274,0,1
07094,07,094,2019,06,0,452,0,0,0,0,0,452,0,1
07096,07,096,2019,06,0,134,0,0,0,0,0,134,0,1
07097,07,097,2019,06,11053,2740,23,0,0,0,0,13816,11076,2
07099,07,099,2019,06,0,508,0,0,0,0,0,508,0,1
07101,07,101,2019,06,54945,43578,17430,0,0,0,0,115953,72375,3
07102,07,102,2019,06,0,622,0,0,0,0,0,622,0,1
07103,07,103,2019,06,0,25,0,0,0,0,0,25,0,1
07104,07,104,2019,06,0,90,0,0,0,0,0,90,0,1
07105,07,105,2019,06,0,255,0,0,0,0,0,255,0,1
07106,07,106,2019,06,0,726,0,0,0,0,0,726,0,1
07107,07,107,2019,06,0,1695,0,0,0,0,0,1695,0,1
07108,07,108,2019,06,3694,3038,87,0,0,0,0,6819,3781,3
07109,07,109,2019,06,0,1200,9,0,0,0,0,1209,9,1
07111,07,111,2019,06,0,4,0,0,0,0,0,4,0,1
08001,08,001,2019,06,0,1070,1,0,0,0,0,1071,1,2
08002,08,002,2019,06,0,1929,1,0,0,0,0,1930,1,1
08003,08,003,2019,06,0,561,0,0,0,0,0,561,0,1
08004,08,004,2019,06,0,160,0,0,0,0,0,160,0,1
08005,08,005,2019,06,2021,943,3,0,0,0,0,2967,2024,2
08009,08,009,2019,06,0,723,0,0,0,0,0,723,0,1
08010,08,010,2019,06,0,764,0,0,0,0,0,764,0,1
08011,08,011,2019,06,4998,2787,5,0,0,0,0,7790,5003,2
08012,08,012,2019,06,0,60,0,0,0,0,0,60,0,1
08013,08,013,2019,06,0,586,10,0,0,0,0,596,10,1
08015,08,015,2019,06,0,1,0,0,0,0,0,1,0,1
08017,08,017,2019,06,10360,10910,3557,0,0,0,0,24827,13917,2
08019,08,019,2019,06,82173,65060,70005,0,0,0,0,217238,152178,3
08021,08,021,2019,06,17076,6793,3166,0,0,0,0,27035,20242,3
08023,08,023,2019,06,0,107,0,0,0,0,0,107,0,1
08024,08,024,2019,06,0,278,0,0,0,0,0,278,0,1
08025,08,025,2019,06,0,391,0,0,0,0,0,391,0,1
08027,08,027,2019,06,0,952,0,0,0,0,0,952,0,1
08028,08,028,2019,06,0,61,0,0,0,0,0,61,0,1
08029,08,029,2019,06,0,156,0,0,0,0,0,156,0,1
08030,08,030,2019,06,0,169,0,0,0,0,0,169,0,1
08031,08,031,2019,06,0,1638,0,0,0,0,0,1638,0,1
08032,08,032,2019,06,11282,8923,812,0,0,0,0,21017,12094,3
08034,08,034,2019,06,0,246,0,0,0,0,0,246,0,1
08035,08,035,2019,06,0,198,6,0,0,0,0,204,6,1
08036,08,036,2019,06,0,4156,6,0,0,0,0,4162,6,1
08037,08,037,2019,06,117262,98123,75509,0,0,0,0,290894,192771,3
08038,08,038,2019,06,0,135,0,0,0,0,0,135,0,1
08039,08,039,2019,06,0,211,1,0,0,0,0,212,1,2
08040,08,040,2019,06,0,1169,0,0,0,0,0,1169,0,1
08042,08,042,2019,06,0,1,0,0,0,0,0,1,0,1
08043,08,043,2019,06,0,83,0,0,0,0,0,83,0,1
08044,08,044,2019,06,0,231,0,0,0,0,0,231,0,1
08045,08,045,2019,06,2249,2125,57,0,0,0,0,4431,2306,2
08048,08,048,2019,06,0,458,0,0,0,0,0,458,0,1
08050,08,050,2019,06,5883,3500,2406,0,0,0,0,11789,8289,2
08051,08,051,2019,06,0,0,4,0,0,0,0,4,4,1
08052,08,052,2019,06,0,2763,6,0,0,0,0,2769,6,1
08053,08,053,2019,06,0,86,0,0,0,0,0,86,0,1
08055,08,055,2019,06,0,324,0,0,0,0,0,324,0,1
08059,08,059,2019,06,0,359,0,0,0,0,0,359,0,1
08060,08,060,2019,06,0,774,0,0,0,0,0,774,0,1
08062,08,062,2019,06,0,2218,0,0,0,0,0,2218,0,1
08063,08,063,2019,06,0,124,0,0,0,0,0,124,0,1
08066,08,066,2019,06,0,0,1,0,0,0,0,1,1,1
08067,08,067,2019,06,0,176,0,0,0,0,0,176,0,1
09002,09,002,2019,06,53239,33221,47677,0,0,0,0,134137,100916,3
09003,09,003,2019,06,63565,19304,70269,0,0,0,0,153138,133834,3
09004,09,004,2019,06,16097,11643,25274,0,0,0,0,53014,41371,3
09005,09,005,2019,06,126157,76058,100016,0,0,0,0,302231,226173,3
09006,09,006,2019,06,40830,31198,48540,0,0,0,0,120568,89370,3
09007,09,007,2019,06,173300,127998,79186,0,0,0,0,380484,252486,3
09008,09,008,2019,06,23955,8058,22987,0,0,0,0,55000,46942,3
09009,09,009,2019,06,4285,14402,1100,0,0,0,0,19787,5385,2
09010,09,010,2019,06,84650,32332,90792,0,0,0,0,207774,175442,3
09011,09,011,2019,06,29669,55881,10399,0,0,0,0,95949,40068,3
09012,09,012,2019,06,59429,37653,84093,0,0,0,0,181175,143522,3
09013,09,013,2019,06,24184,24142,37192,0,0,0,0,85518,61376,3
09014,09,014,2019,06,77631,18096,128158,0,0,0,0,223885,205789,3
09015,09,015,2019,06,68490,41484,123324,0,0,0,0,233298,191814,3
09016,09,016,2019,06,60401,30425,90129,0,0,0,0,180955,150530,3
09017,09,017,2019,06,49536,21279,47707,0,0,0,0,118522,97243,3
10001,10,001,2019,06,0,1312,0,0,0,0,0,1312,0,1
10004,10,004,2019,06,0,1194,1,0,0,0,0,1195,1,2
10005,10,005,2019,06,61351,46597,9817,0,0,0,0,117765,71168,3
10007,10,007,2019,06,27823,17371,3178,0,0,0,0,48372,31001,3
10008,10,008,2019,06,0,2298,36,0,0,0,0,2334,36,1
10012,10,012,2019,06,10247,5530,690,0,0,0,0,16467,10937,3
10013,10,013,2019,06,0,1095,0,0,0,0,0,1095,0,1
10014,10,014,2019,06,0,171,0,0,0,0,0,171,0,1
10015,10,015,2019,06,0,386,0,0,0,0,0,386,0,1
10016,10,016,2019,06,0,228,0,0,0,0,0,228,0,1
10017,10,017,2019,06,0,419,0,0,0,0,0,419,0,1
10018,10,018,2019,06,0,693,0,0,0,0,0,693,0,1
10020,10,020,2019,06,0,435,0,0,0,0,0,435,0,1
10021,10,021,2019,06,0,457,0,0,0,0,0,457,0,1
10022,10,022,2019,06,0,525,0,0,0,0,0,525,0,1
10023,10,023,2019,06,0,1594,366,0,0,0,0,1960,366,1
10024,10,024,2019,06,0,441,0,0,0,0,0,441,0,1
10026,10,026,2019,06,0,245,0,0,0,0,0,245,0,1
10028,10,028,2019,06,0,282,0,0,0,0,0,282,0,1
10031,10,031,2019,06,0,57,0,0,0,0,0,57,0,1
10032,10,032,2019,06,0,1609,0,0,0,0,0,1609,0,1
10033,10,033,2019,06,0,80,0,0,0,0,0,80,0,1
10035,10,035,2019,06,0,254,0,0,0,0,0,254,0,1
10036,10,036,2019,06,0,304,0,0,0,0,0,304,0,1
10037,10,037,2019,06,0,0,1,0,0,0,0,1,1,1
10038,10,038,2019,06,0,800,0,0,0,0,0,800,0,1
10039,10,039,2019,06,0,663,0,0,0,0,0,663,0,1
11001,11,001,2019,06,0,3700,0,0,0,0,0,3700,0,1
11002,11,002,2019,06,102,10273,622,0,0,0,0,10997,724,2
11003,11,003,2019,06,18207,7064,4710,0,0,0,0,29981,22917,3
11004,11,004,2019,06,3466,2410,7,0,0,0,0,5883,3473,2
11005,11,005,2019,06,2985,2775,12,0,0,0,0,5772,2997,3
11007,11,007,2019,06,25423,39897,28425,0,0,0,0,93745,53848,4
11008,11,008,2019,06,0,2230,1,0,0,0,0,2231,1,2
11009,11,009,2019,06,4350,2348,0,0,0,0,0,6698,4350,2
11010,11,010,2019,06,0,549,0,0,0,0,0,549,0,1
11011,11,011,2019,06,1721,8335,377,0,0,0,0,10433,2098,2
11012,11,012,2019,06,0,1652,0,0,0,0,0,1652,0,1
11013,11,013,2019,06,0,719,14,0,0,0,0,733,14,2
11014,11,014,2019,06,9725,3094,2619,0,0,0,0,15438,12344,2
11015,11,015,2019,06,14955,9931,8935,0,0,0,0,33821,23890,3
11016,11,016,2019,06,0,876,0,0,0,0,0,876,0,1
11017,11,017,2019,06,26591,42411,8754,0,0,0,0,77756,35345,3
11018,11,018,2019,06,0,2185,0,0,0,0,0,2185,0,1
11019,11,019,2019,06,0,1339,0,0,0,0,0,1339,0,1
11020,11,020,2019,06,152520,67863,62841,0,0,0,0,283224,215361,3
11021,11,021,2019,06,4834,5017,4282,0,0,0,0,14133,9116,2
11022,11,022,2019,06,0,730,0,0,0,0,0,730,0,1
11023,11,023,2019,06,688,6532,96,0,0,0,0,7316,784,3
11024,11,024,2019,06,0,601,0,0,0,0,0,601,0,1
11025,11,025,2019,06,0,2292,281,0,0,0,0,2573,281,2
11026,11,026,2019,06,1370,1823,0,0,0,0,0,3193,1370,2
11027,11,027,2019,06,32683,13670,2211,0,0,0,0,48564,34894,3
11028,11,028,2019,06,40,9430,996,0,0,0,0,10466,1036,2
11029,11,029,2019,06,0,1006,1,0,0,0,0,1007,1,2
11030,11,030,2019,06,2881,2344,88,0,0,0,0,5313,2969,2
11031,11,031,2019,06,3150,7409,6677,0,0,0,0,17236,9827,3
11032,11,032,2019,06,3822,3371,0,0,0,0,0,7193,3822,2
11033,11,033,2019,06,5176,4412,68,0,0,0,0,9656,5244,2
11035,11,035,2019,06,4155,2570,2,0,0,0,0,6727,4157,3
11036,11,036,2019,06,0,682,0,0,0,0,0,682,0,1
11037,11,037,2019,06,10825,4288,3581,0,0,0,0,18694,14406,3
11038,11,038,2019,06,576,630,0,0,0,0,0,1206,576,2
11039,11,039,2019,06,0,2591,0,0,0,0,0,2591,0,1
11041,11,041,2019,06,0,2864,169,0,0,0,0,3033,169,1
11042,11,042,2019,06,142,9719,62,0,0,0,0,9923,204,3
11043,11,043,2019,06,0,367,0,0,0,0,0,367,0,1
11044,11,044,2019,06,865,4214,743,0,0,0,0,5822,1608,2
11045,11,045,2019,06,0,274,0,0,0,0,0,274,0,1
11046,11,046,2019,06,247,4941,0,0,0,0,0,5188,247,3
12001,12,001,2019,06,55965,47782,24031,0,0,0,0,127778,79996,3
12002,12,002,2019,06,0,159,0,0,0,0,0,159,0,1
12003,12,003,2019,06,0,812,0,0,0,0,0,812,0,1
12004,12,004,2019,06,0,173,0,0,0,0,0,173,0,1
12005,12,005,2019,06,0,280,0,0,0,0,0,280,0,1
12006,12,006,2019,06,0,488,0,0,0,0,0,488,0,1
12007,12,007,2019,06,0,2827,9,0,0,0,0,2836,9,1
12008,12,008,2019,06,0,375,0,0,0,0,0,375,0,1
12011,12,011,2019,06,0,3025,9,0,0,0,0,3034,9,1
12012,12,012,2019,06,0,1289,15,0,0,0,0,1304,15,1
12013,12,013,2019,06,0,280,0,0,0,0,0,280,0,1
12014,12,014,2019,06,0,1494,0,0,0,0,0,1494,0,1
12015,12,015,2019,06,0,677,0,0,0,0,0,677,0,1
12017,12,017,2019,06,0,582,0,0,0,0,0,582,0,1
12018,12,018,2019,06,0,755,0,0,0,0,0,755,0,1
12021,12,021,2019,06,0,4243,92,0,0,0,0,4335,92,2
12022,12,022,2019,06,0,2394,0,0,0,0,0,2394,0,1
12023,12,023,2019,06,0,1127,0,0,0,0,0,1127,0,1
12026,12,026,2019,06,0,116,0,0,0,0,0,116,0,1
12027,12,027,2019,06,0,602,0,0,0,0,0,602,0,1
12028,12,028,2019,06,0,3569,29,0,0,0,0,3598,29,2
12029,12,029,2019,06,17142,23008,3185,0,0,0,0,43335,20327,3
12030,12,030,2019,06,0,930,7,0,0,0,0,937,7,1
12032,12,032,2019,06,0,150,0,0,0,0,0,150,0,1
12033,12,033,2019,06,0,555,0,0,0,0,0,555,0,1
12034,12,034,2019,06,0,2570,1,0,0,0,0,2571,1,1
12035,12,035,2019,06,8013,14493,1128,0,0,0,0,23634,9141,2
12036,12,036,2019,06,0,110,0,0,0,0,0,110,0,1
12037,12,037,2019,06,0,210,0,0,0,0,0,210,0,1
12038,12,038,2019,06,13679,8916,2846,0,0,0,0,25441,16525,2
12039,12,039,2019,06,0,1120,60,0,0,0,0,1180,60,1
12040,12,040,2019,06,0,809,0,0,0,0,0,809,0,1
12042,12,042,2019,06,0,330,0,0,0,0,0,330,0,1
12044,12,044,2019,06,0,597,0,0,0,0,0,597,0,1
12045,12,045,2019,06,0,706,0,0,0,0,0,706,0,1
12046,12,046,2019,06,0,3544,112,0,0,0,0,3656,112,1
12048,12,048,2019,06,2754,1838,48,0,0,0,0,4640,2802,2
12049,12,049,2019,06,0,599,0,0,0,0,0,599,0,1
12050,12,050,2019,06,0,5375,108,0,0,0,0,5483,108,1
12051,12,051,2019,06,0,740,0,0,0,0,0,740,0,1
12052,12,052,2019,06,0,851,0,0,0,0,0,851,0,1
12053,12,053,2019,06,0,1768,35,0,0,0,0,1803,35,1
12054,12,054,2019,06,0,225,0,0,0,0,0,225,0,1
12055,12,055,2019,06,0,11285,185,0,0,0,0,11470,185,1
12057,12,057,2019,06,0,5900,52,0,0,0,0,5952,52,1
12058,12,058,2019,06,0,3081,12,0,0,0,0,3093,12,1
12059,12,059,2019,06,0,1546,0,0,0,0,0,1546,0,1
12060,12,060,2019,06,0,118,0,0,0,0,0,118,0,1
12061,12,061,2019,06,0,3066,16,0,0,0,0,3082,16,1
12062,12,062,2019,06,0,254,0,0,0,0,0,254,0,1
12064,12,064,2019,06,0,549,0,0,0,0,0,549,0,1
12066,12,066,2019,06,0,5053,189,0,0,0,0,5242,189,1
12067,12,067,2019,06,0,1747,0,0,0,0,0,1747,0,1
12068,12,068,2019,06,0,327,0,0,0,0,0,327,0,1
12069,12,069,2019,06,0,76,0,0,0,0,0,76,0,1
12070,12,070,2019,06,0,248,0,0,0,0,0,248,0,1
12071,12,071,2019,06,0,373,0,0,0,0,0,373,0,1
12073,12,073,2019,06,0,462,0,0,0,0,0,462,0,1
12075,12,075,2019,06,1734,2511,10,0,0,0,0,4255,1744,2
12077,12,077,2019,06,0,814,0,0,0,0,0,814,0,1
12080,12,080,2019,06,0,292,0,0,0,0,0,292,0,1
13001,13,001,2019,06,0,696,0,0,0,0,0,696,0,1
13002,13,002,2019,06,0,914,0,0,0,0,0,914,0,1
13003,13,003,2019,06,0,5924,97,0,0,0,0,6021,97,2
13005,13,005,2019,06,0,649,0,0,0,0,0,649,0,1
13006,13,006,2019,06,0,437,0,0,0,0,0,437,0,1
13007,13,007,2019,06,0,538,0,0,0,0,0,538,0,1
13008,13,008,2019,06,1484,4061,48,0,0,0,0,5593,1532,3
13009,13,009,2019,06,0,347,0,0,0,0,0,347,0,1
13010,13,010,2019,06,0,2414,393,0,0,0,0,2807,393,2
13011,13,011,2019,06,0,281,0,0,0,0,0,281,0,1
13012,13,012,2019,06,0,1155,7,0,0,0,0,1162,7,1
13013,13,013,2019,06,2714,1532,1097,0,0,0,0,5343,3811,2
13016,13,016,2019,06,0,1890,8,0,0,0,0,1898,8,1
13017,13,017,2019,06,0,45,0,0,0,0,0,45,0,1
13018,13,018,2019,06,0,323,0,0,0,0,0,323,0,1
13019,13,019,2019,06,0,84,0,0,0,0,0,84,0,1
13021,13,021,2019,06,0,1028,0,0,0,0,0,1028,0,1
13022,13,022,2019,06,542,661,1,0,0,0,0,1204,543,3
13023,13,023,2019,06,0,1783,0,0,0,0,0,1783,0,1
13024,13,024,2019,06,0,514,1,0,0,0,0,515,1,2
13025,13,025,2019,06,0,284,0,0,0,0,0,284,0,1
13027,13,027,2019,06,0,0,1,0,0,0,0,1,1,1
13028,13,028,2019,06,0,5522,117,0,0,0,0,5639,117,2
13029,13,029,2019,06,0,2231,15,0,0,0,0,2246,15,1
13030,13,030,2019,06,979,5281,127,0,0,0,0,6387,1106,3
13031,13,031,2019,06,0,337,0,0,0,0,0,337,0,1
13035,13,035,2019,06,0,80,0,0,0,0,0,80,0,1
13036,13,036,2019,06,0,127,0,0,0,0,0,127,0,1
13037,13,037,2019,06,0,111,0,0,0,0,0,111,0,1
13038,13,038,2019,06,0,88,0,0,0,0,0,88,0,1
13039,13,039,2019,06,319,1179,37,0,0,0,0,1535,356,2
13041,13,041,2019,06,0,3557,21,0,0,0,0,3578,21,1
13042,13,042,2019,06,0,168,1,0,0,0,0,169,1,1
13044,13,044,2019,06,0,327,0,0,0,0,0,327,0,1
13045,13,045,2019,06,124,206,0,0,0,0,0,330,124,2
13046,13,046,2019,06,0,473,0,0,0,0,0,473,0,1
13048,13,048,2019,06,34030,33870,37016,0,0,0,0,104916,71046,3
13050,13,050,2019,06,0,2080,8,0,0,0,0,2088,8,1
13051,13,051,2019,06,0,3056,861,0,0,0,0,3917,861,2
13052,13,052,2019,06,0,1776,177,0,0,0,0,1953,177,2
13053,13,053,2019,06,0,222,2,0,0,0,0,224,2,2
13054,13,054,2019,06,0,276,0,0,0,0,0,276,0,1
13055,13,055,2019,06,0,73,0,0,0,0,0,73,0,1
13056,13,056,2019,06,0,3770,57,0,0,0,0,3827,57,2
13057,13,057,2019,06,0,406,0,0,0,0,0,406,0,1
13058,13,058,2019,06,0,642,7,0,0,0,0,649,7,1
13059,13,059,2019,06,0,729,0,0,0,0,0,729,0,1
13060,13,060,2019,06,0,227,0,0,0,0,0,227,0,1
13061,13,061,2019,06,2091,8216,346,0,0,0,0,10653,2437,3
13062,13,062,2019,06,0,6,0,0,0,0,0,6,0,1
13063,13,063,2019,06,4268,3479,371,0,0,0,0,8118,4639,3
13064,13,064,2019,06,0,217,0,0,0,0,0,217,0,1
13066,13,066,2019,06,0,724,0,0,0,0,0,724,0,1
13067,13,067,2019,06,0,1701,293,0,0,0,0,1994,293,1
13069,13,069,2019,06,3389,8854,2286,0,0,0,0,14529,5675,3
13070,13,070,2019,06,0,1460,6,0,0,0,0,1466,6,1
13072,13,072,2019,06,0,5,1,0,0,0,0,6,1,2
13073,13,073,2019,06,0,177,0,0,0,0,0,177,0,1
13074,13,074,2019,06,0,1410,25,0,0,0,0,1435,25,1
13075,13,075,2019,06,0,321,0,0,0,0,0,321,0,1
13076,13,076,2019,06,6807,8410,1773,0,0,0,0,16990,8580,3
13077,13,077,2019,06,11577,13846,5589,0,0,0,0,31012,17166,3
13081,13,081,2019,06,0,1758,21,0,0,0,0,1779,21,2
13082,13,082,2019,06,0,1081,0,0,0,0,0,1081,0,1
13083,13,083,2019,06,0,830,8,0,0,0,0,838,8,2
13084,13,084,2019,06,0,1611,19,0,0,0,0,1630,19,1
14001,14,001,2019,06,0,953,20,0,0,0,0,973,20,1
14002,14,002,2019,06,1887,1093,0,0,0,0,0,2980,1887,2
14003,14,003,2019,06,0,2965,0,0,0,0,0,2965,0,1
14004,14,004,2019,06,419,303,0,0,0,0,0,722,419,2
14005,14,005,2019,06,0,1107,7,0,0,0,0,1114,7,1
14006,14,006,2019,06,2121,6124,4,0,0,0,0,8249,2125,2
14007,14,007,2019,06,0,679,0,0,0,0,0,679,0,1
14008,14,008,2019,06,7535,5807,17,0,0,0,0,13359,7552,3
14009,14,009,2019,06,0,1153,0,0,0,0,0,1153,0,1
14010,14,010,2019,06,450,173,0,0,0,0,0,623,450,2
14013,14,013,2019,06,0,5035,18,0,0,0,0,5053,18,2
14014,14,014,2019,06,402,549,0,0,0,0,0,951,402,2
14015,14,015,2019,06,3468,8350,79,0,0,0,0,11897,3547,3
14016,14,016,2019,06,0,1827,22,0,0,0,0,1849,22,1
14017,14,017,2019,06,0,1057,0,0,0,0,0,1057,0,1
14018,14,018,2019,06,2959,5635,63,0,0,0,0,8657,3022,2
14020,14,020,2019,06,0,480,0,0,0,0,0,480,0,1
14021,14,021,2019,06,0,2642,0,0,0,0,0,2642,0,1
14022,14,022,2019,06,0,5003,0,0,0,0,0,5003,0,1
14023,14,023,2019,06,8498,16862,237,0,0,0,0,25597,8735,3
14024,14,024,2019,06,0,1786,2,0,0,0,0,1788,2,1
14025,14,025,2019,06,0,2649,0,0,0,0,0,2649,0,1
14026,14,026,2019,06,0,275,0,0,0,0,0,275,0,1
14027,14,027,2019,06,0,695,0,0,0,0,0,695,0,1
14028,14,028,2019,06,0,227,0,0,0,0,0,227,0,1
14029,14,029,2019,06,0,642,1,0,0,0,0,643,1,2
14030,14,030,2019,06,4842,9781,137,0,0,0,0,14760,4979,3
14033,14,033,2019,06,0,1520,0,0,0,0,0,1520,0,1
14034,14,034,2019,06,0,223,0,0,0,0,0,223,0,1
14035,14,035,2019,06,0,3952,0,0,0,0,0,3952,0,1
14036,14,036,2019,06,0,2033,1,0,0,0,0,2034,1,1
14037,14,037,2019,06,2093,2918,0,0,0,0,0,5011,2093,2
14038,14,038,2019,06,0,405,0,0,0,0,0,405,0,1
14039,14,039,2019,06,133140,103323,152149,0,0,0,0,388612,285289,3
14041,14,041,2019,06,0,541,0,0,0,0,0,541,0,1
14042,14,042,2019,06,0,476,0,0,0,0,0,476,0,1
14043,14,043,2019,06,0,2922,26,0,0,0,0,2948,26,1
14044,14,044,2019,06,7807,2139,0,0,0,0,0,9946,7807,2
14045,14,045,2019,06,0,1098,0,0,0,0,0,1098,0,1
14046,14,046,2019,06,1166,2747,0,0,0,0,0,3913,1166,2
14047,14,047,2019,06,0,1938,0,0,0,0,0,1938,0,1
14048,14,048,2019,06,0,1085,115,0,0,0,0,1200,115,2
14049,14,049,2019,06,0,1,0,0,0,0,0,1,0,1
14050,14,050,2019,06,0,3460,66,0,0,0,0,3526,66,1
14051,14,051,2019,06,0,1,0,0,0,0,0,1,0,1
14052,14,052,2019,06,0,603,0,0,0,0,0,603,0,1
14053,14,053,2019,06,11257,9968,103,0,0,0,0,21328,11360,3
14054,14,054,2019,06,0,536,0,0,0,0,0,536,0,1
14055,14,055,2019,06,0,1526,1,0,0,0,0,1527,1,2
14057,14,057,2019,06,0,179,0,0,0,0,0,179,0,1
14058,14,058,2019,06,0,1892,0,0,0,0,0,1892,0,1
14059,14,059,2019,06,1735,655,0,0,0,0,0,2390,1735,2
14060,14,060,2019,06,0,295,0,0,0,0,0,295,0,1
14061,14,061,2019,06,0,239,0,0,0,0,0,239,0,1
14062,14,062,2019,06,0,1,0,0,0,0,0,1,0,1
14063,14,063,2019,06,9648,7860,216,0,0,0,0,17724,9864,2
14064,14,064,2019,06,0,1459,0,0,0,0,0,1459,0,1
14065,14,065,2019,06,0,730,0,0,0,0,0,730,0,1
14066,14,066,2019,06,242,2473,14,0,0,0,0,2729,256,2
14067,14,067,2019,06,28142,36949,13162,0,0,0,0,78253,41304,3
14068,14,068,2019,06,0,782,0,0,0,0,0,782,0,1
14069,14,069,2019,06,0,279,0,0,0,0,0,279,0,1
14070,14,070,2019,06,49,11426,8968,0,0,0,0,20443,9017,3
14072,14,072,2019,06,0,589,0,0,0,0,0,589,0,1
14073,14,073,2019,06,2100,6885,44,0,0,0,0,9029,2144,2
14074,14,074,2019,06,692,1806,0,0,0,0,0,2498,692,2
14075,14,075,2019,06,0,371,0,0,0,0,0,371,0,1
14077,14,077,2019,06,0,2898,0,0,0,0,0,2898,0,1
14078,14,078,2019,06,1618,2866,3,0,0,0,0,4487,1621,2
14079,14,079,2019,06,0,989,0,0,0,0,0,989,0,1
14080,14,080,2019,06,0,155,0,0,0,0,0,155,0,1
14081,14,081,2019,06,0,210,0,0,0,0,0,210,0,1
14082,14,082,2019,06,2828,3435,2,0,0,0,0,6265,2830,2
14083,14,083,2019,06,6434,4504,15,0,0,0,0,10953,6449,3
14084,14,084,2019,06,0,1305,0,0,0,0,0,1305,0,1
14085,14,085,2019,06,0,4033,0,0,0,0,0,4033,0,1
14086,14,086,2019,06,934,1006,0,0,0,0,0,1940,934,2
14087,14,087,2019,06,0,1781,0,0,0,0,0,1781,0,1
14088,14,088,2019,06,0,1555,0,0,0,0,0,1555,0,1
14089,14,089,2019,06,0,199,0,0,0,0,0,199,0,1
14090,14,090,2019,06,0,641,7,0,0,0,0,648,7,1
14091,14,091,2019,06,0,3847,0,0,0,0,0,3847,0,1
14092,14,092,2019,06,1794,494,0,0,0,0,0,2288,1794,2
14093,14,093,2019,06,9347,11011,2750,0,0,0,0,23108,12097,3
14094,14,094,2019,06,2554,3410,45,0,0,0,0,6009,2599,2
14095,14,095,2019,06,0,525,0,0,0,0,0,525,0,1
14096,14,096,2019,06,1248,622,0,0,0,0,0,1870,1248,2
14097,14,097,2019,06,83327,15165,9325,0,0,0,0,107817,92652,3
14098,14,098,2019,06,52284,48271,44851,0,0,0,0,145406,97135,3
14099,14,099,2019,06,0,109,0,0,0,0,0,109,0,1
14100,14,100,2019,06,0,2197,0,0,0,0,0,2197,0,1
14101,14,101,2019,06,50272,25758,18117,0,0,0,0,94147,68389,3
14102,14,102,2019,06,251,493,0,0,0,0,0,744,251,2
14103,14,103,2019,06,0,762,0,0,0,0,0,762,0,1
14104,14,104,2019,06,0,456,0,0,0,0,0,456,0,1
14105,14,105,2019,06,0,1338,8,0,0,0,0,1346,8,2
14107,14,107,2019,06,466,161,0,0,0,0,0,627,466,2
14108,14,108,2019,06,0,3117,1,0,0,0,0,3118,1,1
14109,14,109,2019,06,0,981,0,0,0,0,0,981,0,1
14110,14,110,2019,06,570,1441,1,0,0,0,0,2012,571,2
14111,14,111,2019,06,0,450,0,0,0,0,0,450,0,1
14112,14,112,2019,06,731,312,0,0,0,0,0,1043,731,2
14113,14,113,2019,06,0,736,0,0,0,0,0,736,0,1
14114,14,114,2019,06,1040,942,0,0,0,0,0,1982,1040,2
14115,14,115,2019,06,0,552,0,0,0,0,0,552,0,1
14116,14,116,2019,06,0,2391,0,0,0,0,0,2391,0,1
14118,14,118,2019,06,0,1734,2,0,0,0,0,1736,2,2
14119,14,119,2019,06,579,1608,1,0,0,0,0,2188,580,3
14120,14,120,2019,06,73580,99065,144684,0,0,0,0,317329,218264,3
14121,14,121,2019,06,0,2321,0,0,0,0,0,2321,0,1
14122,14,122,2019,06,0,180,0,0,0,0,0,180,0,1
14123,14,123,2019,06,0,640,1,0,0,0,0,641,1,2
14124,14,124,2019,06,3344,3679,169,0,0,0,0,7192,3513,3
14125,14,125,2019,06,0,648,0,0,0,0,0,648,0,1
15001,15,001,2019,06,843,1164,0,0,0,0,0,2007,843,2
15002,15,002,2019,06,3754,12521,37,0,0,0,0,16312,3791,3
15003,15,003,2019,06,0,926,0,0,0,0,0,926,0,1
15004,15,004,2019,06,0,677,0,0,0,0,0,677,0,1
15005,15,005,2019,06,5273,4016,10,0,0,0,0,9299,5283,2
15007,15,007,2019,06,0,479,0,0,0,0,0,479,0,1
15008,15,008,2019,06,0,534,0,0,0,0,0,534,0,1
15009,15,009,2019,06,1605,4818,246,0,0,0,0,6669,1851,2
15010,15,010,2019,06,0,2172,307,0,0,0,0,2479,307,1
15011,15,011,2019,06,0,248,2,0,0,0,0,250,2,2
15012,15,012,2019,06,0,1826,64,0,0,0,0,1890,64,2
15013,15,013,2019,06,40212,21012,36504,0,0,0,0,97728,76716,3
15014,15,014,2019,06,8536,5938,722,0,0,0,0,15196,9258,3
15015,15,015,2019,06,0,1041,182,0,0,0,0,1223,182,1
15016,15,016,2019,06,0,1045,0,0,0,0,0,1045,0,1
15017,15,017,2019,06,0,489,0,0,0,0,0,489,0,1
15018,15,018,2019,06,2775,5126,501,0,0,0,0,8402,3276,3
15019,15,019,2019,06,0,922,7,0,0,0,0,929,7,1
15020,15,020,2019,06,14584,33690,18365,0,0,0,0,66639,32949,4
15021,15,021,2019,06,0,1340,3,0,0,0,0,1343,3,1
15022,15,022,2019,06,0,2167,0,0,0,0,0,2167,0,1
15023,15,023,2019,06,1874,3551,75,0,0,0,0,5500,1949,2
15024,15,024,2019,06,5200,18310,23025,0,0,0,0,46535,28225,3
15025,15,025,2019,06,11779,48901,1584,0,0,0,0,62264,13363,4
15026,15,026,2019,06,0,973,0,0,0,0,0,973,0,1
15027,15,027,2019,06,0,0,5,0,0,0,0,5,5,1
15028,15,028,2019,06,0,166,0,0,0,0,0,166,0,1
15029,15,029,2019,06,13473,17321,119,0,0,0,0,30913,13592,4
15030,15,030,2019,06,0,5699,1890,0,0,0,0,7589,1890,1
15031,15,031,2019,06,23526,50281,9136,0,0,0,0,82943,32662,3
15032,15,032,2019,06,0,241,0,0,0,0,0,241,0,1
15033,15,033,2019,06,67691,128080,89246,0,0,0,0,285017,156937,4
15034,15,034,2019,06,0,511,0,0,0,0,0,511,0,1
15035,15,035,2019,06,13387,5066,47,0,0,0,0,18500,13434,2
15036,15,036,2019,06,437,1937,0,0,0,0,0,2374,437,2
15037,15,037,2019,06,17059,14694,25510,0,0,0,0,57263,42569,4
15038,15,038,2019,06,0,793,95,0,0,0,0,888,95,1
15039,15,039,2019,06,67123,39533,324,0,0,0,0,106980,67447,3
15040,15,040,2019,06,1303,1971,405,0,0,0,0,3679,1708,2
15041,15,041,2019,06,0,97,0,0,0,0,0,97,0,1
15042,15,042,2019,06,3629,2115,2843,0,0,0,0,8587,6472,3
15043,15,043,2019,06,1492,1937,0,0,0,0,0,3429,1492,2
15044,15,044,2019,06,0,316,0,0,0,0,0,316,0,1
15045,15,045,2019,06,0,3269,73,0,0,0,0,3342,73,1
15046,15,046,2019,06,0,2998,98,0,0,0,0,3096,98,1
15047,15,047,2019,06,0,1400,0,0,0,0,0,1400,0,1
15048,15,048,2019,06,2231,1784,0,0,0,0,0,4015,2231,2
15049,15,049,2019,06,873,490,0,0,0,0,0,1363,873,2
15050,15,050,2019,06,0,1790,1,0,0,0,0,1791,1,1
15051,15,051,2019,06,8447,10452,4864,0,0,0,0,23763,13311,3
15052,15,052,2019,06,0,2116,300,0,0,0,0,2416,300,2
15053,15,053,2019,06,2253,3889,5499,0,0,0,0,11641,7752,3
15054,15,054,2019,06,14552,6176,19544,0,0,0,0,40272,34096,3
15055,15,055,2019,06,2234,1990,197,0,0,0,0,4421,2431,3
15056,15,056,2019,06,0,367,0,0,0,0,0,367,0,1
15057,15,057,2019,06,76916,42477,81579,0,0,0,0,200972,158495,3
15058,15,058,2019,06,50400,50317,91514,0,0,0,0,192231,141914,4
15059,15,059,2019,06,477,1968,1,0,0,0,0,2446,478,3
15060,15,060,2019,06,16096,41891,6061,0,0,0,0,64048,22157,4
15061,15,061,2019,06,0,916,0,0,0,0,0,916,0,1
15062,15,062,2019,06,5068,4147,26,0,0,0,0,9241,5094,3
15063,15,063,2019,06,0,615,0,0,0,0,0,615,0,1
15064,15,064,2019,06,27,1484,1,0,0,0,0,1512,28,2
15065,15,065,2019,06,0,2270,83,0,0,0,0,2353,83,1
15066,15,066,2019,06,0,156,0,0,0,0,0,156,0,1
15067,15,067,2019,06,1987,2025,4,0,0,0,0,4016,1991,3
15068,15,068,2019,06,0,3341,2,0,0,0,0,3343,2,1
15069,15,069,2019,06,0,322,0,0,0,0,0,322,0,1
15070,15,070,2019,06,10406,30801,2245,0,0,0,0,43452,12651,4
15071,15,071,2019,06,0,679,0,0,0,0,0,679,0,1
15072,15,072,2019,06,1586,57,0,0,0,0,0,1643,1586,2
15073,15,073,2019,06,2343,2584,74,0,0,0,0,5001,2417,3
15074,15,074,2019,06,0,1546,9,0,0,0,0,1555,9,1
15075,15,075,2019,06,0,1665,185,0,0,0,0,1850,185,1
15076,15,076,2019,06,6154,3181,307,0,0,0,0,9642,6461,3
15077,15,077,2019,06,0,33,0,0,0,0,0,33,0,1
15078,15,078,2019,06,413,94,0,0,0,0,0,507,413,2
15079,15,079,2019,06,0,324,0,0,0,0,0,324,0,1
15080,15,080,2019,06,0,642,0,0,0,0,0,642,0,1
15081,15,081,2019,06,29931,31737,14793,0,0,0,0,76461,44724,4
15082,15,082,2019,06,0,4502,18,0,0,0,0,4520,18,1
15083,15,083,2019,06,0,994,0,0,0,0,0,994,0,1
15084,15,084,2019,06,0,1833,0,0,0,0,0,1833,0,1
15085,15,085,2019,06,1561,2093,5,0,0,0,0,3659,1566,2
15086,15,086,2019,06,0,519,0,0,0,0,0,519,0,1
15087,15,087,2019,06,3489,707,0,0,0,0,0,4196,3489,2
15088,15,088,2019,06,6901,5839,122,0,0,0,0,12862,7023,2
15089,15,089,2019,06,0,993,0,0,0,0,0,993,0,1
15090,15,090,2019,06,5277,3304,6,0,0,0,0,8587,5283,3
15091,15,091,2019,06,1972,5271,327,0,0,0,0,7570,2299,2
15092,15,092,2019,06,3249,4355,190,0,0,0,0,7794,3439,3
15093,15,093,2019,06,0,2606,1,0,0,0,0,2607,1,2
15094,15,094,2019,06,0,1579,1,0,0,0,0,1580,1,2
15095,15,095,2019,06,1486,8755,280,0,0,0,0,10521,1766,3
15096,15,096,2019,06,0,2522,24,0,0,0,0,2546,24,1
15097,15,097,2019,06,0,587,0,0,0,0,0,587,0,1
15099,15,099,2019,06,6200,24592,6474,0,0,0,0,37266,12674,3
15100,15,100,2019,06,0,2619,0,0,0,0,0,2619,0,1
15101,15,101,2019,06,9653,3963,1599,0,0,0,0,15215,11252,3
15102,15,102,2019,06,0,571,0,0,0,0,0,571,0,1
15103,15,103,2019,06,0,4343,1732,0,0,0,0,6075,1732,1
15104,15,104,2019,06,76170,40807,62515,0,0,0,0,179492,138685,4
15105,15,105,2019,06,0,60,0,0,0,0,0,60,0,1
15106,15,106,2019,06,56140,61332,77934,0,0,0,0,195406,134074,3
15107,15,107,2019,06,0,951,111,0,0,0,0,1062,111,1
15108,15,108,2019,06,6709,19138,4290,0,0,0,0,30137,10999,5
15109,15,109,2019,06,20606,51269,30664,0,0,0,0,102539,51270,4
15110,15,110,2019,06,5154,4011,5779,0,0,0,0,14944,10933,2
15111,15,111,2019,06,0,188,0,0,0,0,0,188,0,1
15112,15,112,2019,06,0,1823,59,0,0,0,0,1882,59,2
15113,15,113,2019,06,311,3087,7,0,0,0,0,3405,318,2
15114,15,114,2019,06,0,754,1,0,0,0,0,755,1,1
15115,15,115,2019,06,4780,2029,95,0,0,0,0,6904,4875,2
15116,15,116,2019,06,0,220,0,0,0,0,0,220,0,1
15117,15,117,2019,06,0,335,0,0,0,0,0,335,0,1
15118,15,118,2019,06,12715,7996,1471,0,0,0,0,22182,14186,3
15119,15,119,2019,06,0,430,0,0,0,0,0,430,0,1
15120,15,120,2019,06,24275,12841,215,0,0,0,0,37331,24490,4
15121,15,121,2019,06,43555,49683,22637,0,0,0,0,115875,66192,3
15122,15,122,2019,06,148,24181,63,0,0,0,0,24392,211,3
15123,15,123,2019,06,0,746,0,0,0,0,0,746,0,1
15124,15,124,2019,06,0,193,2,0,0,0,0,195,2,2
15125,15,125,2019,06,0,432,0,0,0,0,0,432,0,1
16001,16,001,2019,06,819,258,0,0,0,0,0,1077,819,2
16002,16,002,2019,06,0,272,0,0,0,0,0,272,0,1
16003,16,003,2019,06,0,732,1,0,0,0,0,733,1,2
16004,16,004,2019,06,695,0,0,0,0,0,0,695,695,1
16005,16,005,2019,06,311,291,0,0,0,0,0,602,311,2
16006,16,006,2019,06,0,11546,55,0,0,0,0,11601,55,2
16008,16,008,2019,06,0,638,0,0,0,0,0,638,0,1
16009,16,009,2019,06,0,1553,1,0,0,0,0,1554,1,1
16010,16,010,2019,06,0,567,0,0,0,0,0,567,0,1
16012,16,012,2019,06,0,536,0,0,0,0,0,536,0,1
16013,16,013,2019,06,0,70,0,0,0,0,0,70,0,1
16014,16,014,2019,06,0,1208,0,0,0,0,0,1208,0,1
16015,16,015,2019,06,0,721,0,0,0,0,0,721,0,1
16016,16,016,2019,06,0,193,0,0,0,0,0,193,0,1
16017,16,017,2019,06,0,476,0,0,0,0,0,476,0,1
16018,16,018,2019,06,0,59,0,0,0,0,0,59,0,1
16019,16,019,2019,06,0,2304,0,0,0,0,0,2304,0,1
16020,16,020,2019,06,1094,410,0,0,0,0,0,1504,1094,2
16022,16,022,2019,06,1013,124,0,0,0,0,0,1137,1013,2
16023,16,023,2019,06,1047,258,0,0,0,0,0,1305,1047,2
16024,16,024,2019,06,0,699,0,0,0,0,0,699,0,1
16025,16,025,2019,06,2205,624,0,0,0,0,0,2829,2205,2
16026,16,026,2019,06,0,23,0,0,0,0,0,23,0,1
16027,16,027,2019,06,0,14,0,0,0,0,0,14,0,1
16028,16,028,2019,06,1357,169,0,0,0,0,0,1526,1357,2
16029,16,029,2019,06,0,91,0,0,0,0,0,91,0,1
16030,16,030,2019,06,0,382,0,0,0,0,0,382,0,1
16032,16,032,2019,06,0,215,0,0,0,0,0,215,0,1
16033,16,033,2019,06,0,737,1,0,0,0,0,738,1,1
16034,16,034,2019,06,6603,6460,53,0,0,0,0,13116,6656,3
16035,16,035,2019,06,0,670,0,0,0,0,0,670,0,1
16036,16,036,2019,06,1060,319,0,0,0,0,0,1379,1060,2
16038,16,038,2019,06,0,3408,1,0,0,0,0,3409,1,1
16040,16,040,2019,06,757,190,0,0,0,0,0,947,757,2
16042,16,042,2019,06,0,353,0,0,0,0,0,353,0,1
16043,16,043,2019,06,7611,2884,13,0,0,0,0,10508,7624,2
16044,16,044,2019,06,0,671,0,0,0,0,0,671,0,1
16045,16,045,2019,06,4628,2160,6,0,0,0,0,6794,4634,2
16046,16,046,2019,06,0,380,0,0,0,0,0,380,0,1
16047,16,047,2019,06,0,298,0,0,0,0,0,298,0,1
16048,16,048,2019,06,0,41,0,0,0,0,0,41,0,1
16049,16,049,2019,06,0,258,0,0,0,0,0,258,0,1
16050,16,050,2019,06,3585,2421,2,0,0,0,0,6008,3587,2
16051,16,051,2019,06,1961,491,0,0,0,0,0,2452,1961,2
16052,16,052,2019,06,0,20425,70,0,0,0,0,20495,70,2
16053,16,053,2019,06,88248,45579,38755,0,0,0,0,172582,127003,3
16055,16,055,2019,06,0,2523,12,0,0,0,0,2535,12,1
16056,16,056,2019,06,0,412,0,0,0,0,0,412,0,1
16058,16,058,2019,06,0,1087,0,0,0,0,0,1087,0,1
16060,16,060,2019,06,1008,396,0,0,0,0,0,1404,1008,2
16061,16,061,2019,06,0,183,0,0,0,0,0,183,0,1
16062,16,062,2019,06,910,654,0,0,0,0,0,1564,910,2
16063,16,063,2019,06,0,371,0,0,0,0,0,371,0,1
16064,16,064,2019,06,0,669,0,0,0,0,0,669,0,1
16065,16,065,2019,06,0,2034,0,0,0,0,0,2034,0,1
16066,16,066,2019,06,7868,4737,59,0,0,0,0,12664,7927,2
16067,16,067,2019,06,0,246,0,0,0,0,0,246,0,1
16068,16,068,2019,06,0,2117,1,0,0,0,0,2118,1,1
16069,16,069,2019,06,11220,10236,118,0,0,0,0,21574,11338,2
16070,16,070,2019,06,1,1482,1,0,0,0,0,1484,2,2
16071,16,071,2019,06,4613,1827,42,0,0,0,0,6482,4655,2
16072,16,072,2019,06,0,739,0,0,0,0,0,739,0,1
16073,16,073,2019,06,1141,788,1,0,0,0,0,1930,1142,2
16074,16,074,2019,06,777,192,0,0,0,0,0,969,777,2
16075,16,075,2019,06,1703,8286,315,0,0,0,0,10304,2018,2
16076,16,076,2019,06,7726,5184,172,0,0,0,0,13082,7898,2
16077,16,077,2019,06,0,1187,0,0,0,0,0,1187,0,1
16078,16,078,2019,06,659,459,0,0,0,0,0,1118,659,2
16079,16,079,2019,06,367,1117,0,0,0,0,0,1484,367,2
16080,16,080,2019,06,0,62,0,0,0,0,0,62,0,1
16082,16,082,2019,06,0,2678,4,0,0,0,0,2682,4,1
16083,16,083,2019,06,0,698,0,0,0,0,0,698,0,1
16084,16,084,2019,06,0,1080,0,0,0,0,0,1080,0,1
16085,16,085,2019,06,2266,1176,1,0,0,0,0,3443,2267,2
16086,16,086,2019,06,495,931,0,0,0,0,0,1426,495,2
16087,16,087,2019,06,526,476,0,0,0,0,0,1002,526,2
16088,16,088,2019,06,9839,631,0,0,0,0,0,10470,9839,2
16089,16,089,2019,06,0,1330,1,0,0,0,0,1331,1,1
16090,16,090,2019,06,0,1,0,0,0,0,0,1,0,1
16091,16,091,2019,06,0,1480,0,0,0,0,0,1480,0,1
16092,16,092,2019,06,0,74,0,0,0,0,0,74,0,1
16093,16,093,2019,06,0,1169,0,0,0,0,0,1169,0,1
16094,16,094,2019,06,709,0,0,0,0,0,0,709,709,1
16095,16,095,2019,06,0,502,0,0,0,0,0,502,0,1
16096,16,096,2019,06,0,41,0,0,0,0,0,41,0,1
16098,16,098,2019,06,9401,865,0,0,0,0,0,10266,9401,2
16099,16,099,2019,06,0,379,0,0,0,0,0,379,0,1
16100,16,100,2019,06,560,178,0,0,0,0,0,738,560,2
16102,16,102,2019,06,39351,18741,3127,0,0,0,0,61219,42478,3
16103,16,103,2019,06,810,1261,0,0,0,0,0,2071,810,2
16104,16,104,2019,06,645,420,0,0,0,0,0,1065,645,2
16105,16,105,2019,06,763,717,0,0,0,0,0,1480,763,2
16106,16,106,2019,06,2399,2279,1,0,0,0,0,4679,2400,2
16107,16,107,2019,06,7,7083,69,0,0,0,0,7159,76,2
16108,16,108,2019,06,29583,11658,2040,0,0,0,0,43281,31623,3
16109,16,109,2019,06,0,117,0,0,0,0,0,117,0,1
16110,16,110,2019,06,2384,1161,2,0,0,0,0,3547,2386,2
16111,16,111,2019,06,688,253,0,0,0,0,0,941,688,2
16112,16,112,2019,06,12775,6147,100,0,0,0,0,19022,12875,2
16113,16,113,2019,06,940,495,0,0,0,0,0,1435,940,2
17001,17,001,2019,06,0,1837,0,0,0,0,0,1837,0,1
17002,17,002,2019,06,0,1589,0,0,0,0,0,1589,0,1
17003,17,003,2019,06,0,3544,12,0,0,0,0,3556,12,2
17004,17,004,2019,06,0,7207,13,0,0,0,0,7220,13,2
17005,17,005,2019,06,0,1266,0,0,0,0,0,1266,0,1
17006,17,006,2019,06,24299,16195,2086,0,0,0,0,42580,26385,3
17007,17,007,2019,06,95040,35895,40562,0,0,0,0,171497,135602,3
17008,17,008,2019,06,0,3647,3864,0,0,0,0,7511,3864,2
17009,17,009,2019,06,0,2441,803,0,0,0,0,3244,803,1
17010,17,010,2019,06,0,1771,0,0,0,0,0,1771,0,1
17011,17,011,2019,06,0,4641,6351,0,0,0,0,10992,6351,2
17012,17,012,2019,06,5537,5471,2992,0,0,0,0,14000,8529,2
17013,17,013,2019,06,0,1882,0,0,0,0,0,1882,0,1
17014,17,014,2019,06,0,1120,0,0,0,0,0,1120,0,1
17015,17,015,2019,06,375,3016,0,0,0,0,0,3391,375,2
17016,17,016,2019,06,0,1432,0,0,0,0,0,1432,0,1
17017,17,017,2019,06,4958,4265,198,0,0,0,0,9421,5156,3
17018,17,018,2019,06,0,7148,2280,0,0,0,0,9428,2280,2
17019,17,019,2019,06,0,2356,0,0,0,0,0,2356,0,1
17020,17,020,2019,06,1219,6526,32,0,0,0,0,7777,1251,2
17021,17,021,2019,06,0,973,0,0,0,0,0,973,0,1
17022,17,022,2019,06,0,1343,0,0,0,0,0,1343,0,1
17023,17,023,2019,06,0,473,0,0,0,0,0,473,0,1
17024,17,024,2019,06,5080,2135,1,0,0,0,0,7216,5081,2
17025,17,025,2019,06,2357,1171,1,0,0,0,0,3529,2358,2
17026,17,026,2019,06,0,1674,0,0,0,0,0,1674,0,1
17027,17,027,2019,06,0,727,0,0,0,0,0,727,0,1
17028,17,028,2019,06,0,3853,1546,0,0,0,0,5399,1546,2
17029,17,029,2019,06,4451,11458,3240,0,0,0,0,19149,7691,2
17030,17,030,2019,06,0,4173,8,0,0,0,0,4181,8,1
17031,17,031,2019,06,4238,2959,12,0,0,0,0,7209,4250,2
17032,17,032,2019,06,0,1741,0,0,0,0,0,1741,0,1
17033,17,033,2019,06,0,592,0,0,0,0,0,592,0,1
18001,18,001,2019,06,0,3222,1,0,0,0,0,3223,1,1
18002,18,002,2019,06,0,1094,0,0,0,0,0,1094,0,1
18003,18,003,2019,06,0,873,0,0,0,0,0,873,0,1
18004,18,004,2019,06,0,8344,130,0,0,0,0,8474,130,1
18005,18,005,2019,06,0,187,0,0,0,0,0,187,0,1
18006,18,006,2019,06,0,3561,3,0,0,0,0,3564,3,1
18007,18,007,2019,06,0,993,0,0,0,0,0,993,0,1
18008,18,008,2019,06,7770,3173,1,0,0,0,0,10944,7771,2
18009,18,009,2019,06,0,1,0,0,0,0,0,1,0,1
18010,18,010,2019,06,0,661,0,0,0,0,0,661,0,1
18011,18,011,2019,06,0,1655,0,0,0,0,0,1655,0,1
18012,18,012,2019,06,0,2842,1,0,0,0,0,2843,1,1
18013,18,013,2019,06,0,625,0,0,0,0,0,625,0,1
18014,18,014,2019,06,273,1055,0,0,0,0,0,1328,273,2
18015,18,015,2019,06,0,6633,152,0,0,0,0,6785,152,2
18016,18,016,2019,06,0,3336,0,0,0,0,0,3336,0,1
18017,18,017,2019,06,56855,28414,5560,0,0,0,0,90829,62415,3
18018,18,018,2019,06,0,3504,0,0,0,0,0,3504,0,1
18020,18,020,2019,06,0,21494,4787,0,0,0,0,26281,4787,2
19001,19,001,2019,06,93,0,1,0,0,0,0,94,94,2
19002,19,002,2019,06,0,380,0,0,0,0,0,380,0,1
19003,19,003,2019,06,0,108,0,0,0,0,0,108,0,1
19004,19,004,2019,06,2524,4328,443,0,0,0,0,7295,2967,3
19005,19,005,2019,06,0,2284,1,0,0,0,0,2285,1,2
19006,19,006,2019,06,83615,31116,33095,0,0,0,0,147826,116710,3
19007,19,007,2019,06,0,505,1,0,0,0,0,506,1,2
19008,19,008,2019,06,0,480,0,0,0,0,0,480,0,1
19009,19,009,2019,06,8309,5722,3543,0,0,0,0,17574,11852,2
19010,19,010,2019,06,8855,677,335,0,0,0,0,9867,9190,2
19011,19,011,2019,06,0,1222,0,0,0,0,0,1222,0,1
19012,19,012,2019,06,6515,1806,621,0,0,0,0,8942,7136,3
19013,19,013,2019,06,0,1535,0,0,0,0,0,1535,0,1
19014,19,014,2019,06,0,1325,0,0,0,0,0,1325,0,1
19015,19,015,2019,06,0,23,0,0,0,0,0,23,0,1
19016,19,016,2019,06,0,184,0,0,0,0,0,184,0,1
19017,19,017,2019,06,0,1023,1,0,0,0,0,1024,1,2
19018,19,018,2019,06,49139,4205,1557,0,0,0,0,54901,50696,3
19019,19,019,2019,06,7147,4995,20833,0,0,0,0,32975,27980,3
19020,19,020,2019,06,0,711,0,0,0,0,0,711,0,1
19021,19,021,2019,06,44405,19832,22414,0,0,0,0,86651,66819,3
19022,19,022,2019,06,0,932,0,0,0,0,0,932,0,1
19023,19,023,2019,06,0,216,0,0,0,0,0,216,0,1
19024,19,024,2019,06,0,137,0,0,0,0,0,137,0,1
19025,19,025,2019,06,12984,674,9,0,0,0,0,13667,12993,2
19026,19,026,2019,06,62717,47434,38897,0,0,0,0,149048,101614,3
19027,19,027,2019,06,0,198,0,0,0,0,0,198,0,1
19028,19,028,2019,06,0,136,0,0,0,0,0,136,0,1
19029,19,029,2019,06,452,581,0,0,0,0,0,1033,452,2
19030,19,030,2019,06,0,172,0,0,0,0,0,172,0,1
19031,19,031,2019,06,54906,10986,3432,0,0,0,0,69324,58338,3
19032,19,032,2019,06,0,589,0,0,0,0,0,589,0,1
19033,19,033,2019,06,7450,3309,2721,0,0,0,0,13480,10171,2
19034,19,034,2019,06,274,327,4,0,0,0,0,605,278,2
19035,19,035,2019,06,0,122,0,0,0,0,0,122,0,1
19037,19,037,2019,06,89,212,0,0,0,0,0,301,89,2
19038,19,038,2019,06,4605,3110,3816,0,0,0,0,11531,8421,3
19039,19,039,2019,06,101661,66949,138161,0,0,0,0,306771,239822,3
19040,19,040,2019,06,0,178,0,0,0,0,0,178,0,1
19041,19,041,2019,06,14674,324,5,0,0,0,0,15003,14679,2
19042,19,042,2019,06,0,216,0,0,0,0,0,216,0,1
19043,19,043,2019,06,0,26,0,0,0,0,0,26,0,1
19044,19,044,2019,06,2075,2998,1830,0,0,0,0,6903,3905,3
19045,19,045,2019,06,8398,1398,47,0,0,0,0,9843,8445,2
19046,19,046,2019,06,38241,24145,23429,0,0,0,0,85815,61670,3
19047,19,047,2019,06,635,1407,1,0,0,0,0,2043,636,3
19048,19,048,2019,06,28202,17979,14263,0,0,0,0,60444,42465,3
19049,19,049,2019,06,2671,4034,4541,0,0,0,0,11246,7212,3
19050,19,050,2019,06,0,54,0,0,0,0,0,54,0,1
19051,19,051,2019,06,0,441,0,0,0,0,0,441,0,1
20002,20,002,2019,06,0,1544,0,0,0,0,0,1544,0,1
20005,20,005,2019,06,0,663,0,0,0,0,0,663,0,1
20006,20,006,2019,06,0,896,12,0,0,0,0,908,12,1
20009,20,009,2019,06,0,53,0,0,0,0,0,53,0,1
20010,20,010,2019,06,0,1166,0,0,0,0,0,1166,0,1
20014,20,014,2019,06,2398,1758,39,0,0,0,0,4195,2437,2
20021,20,021,2019,06,0,1,0,0,0,0,0,1,0,1
20023,20,023,2019,06,0,638,1,0,0,0,0,639,1,1
20025,20,025,2019,06,0,696,0,0,0,0,0,696,0,1
20028,20,028,2019,06,0,995,0,0,0,0,0,995,0,1
20030,20,030,2019,06,0,874,0,0,0,0,0,874,0,1
20033,20,033,2019,06,0,163,0,0,0,0,0,163,0,1
20039,20,039,2019,06,0,8730,219,0,0,0,0,8949,219,2
20041,20,041,2019,06,0,498,0,0,0,0,0,498,0,1
20042,20,042,2019,06,0,218,0,0,0,0,0,218,0,1
20043,20,043,2019,06,8331,4675,61,0,0,0,0,13067,8392,2
20044,20,044,2019,06,1407,2613,15,0,0,0,0,4035,1422,3
20052,20,052,2019,06,0,219,0,0,0,0,0,219,0,1
20055,20,055,2019,06,0,88,0,0,0,0,0,88,0,1
20057,20,057,2019,06,1,3558,12,0,0,0,0,3571,13,2
20059,20,059,2019,06,0,1877,91,0,0,0,0,1968,91,1
20064,20,064,2019,06,0,209,0,0,0,0,0,209,0,1
20066,20,066,2019,06,0,224,0,0,0,0,0,224,0,1
20067,20,067,2019,06,61465,30302,15162,0,0,0,0,106929,76627,3
20068,20,068,2019,06,0,1846,1,0,0,0,0,1847,1,2
20070,20,070,2019,06,0,297,0,0,0,0,0,297,0,1
20073,20,073,2019,06,0,1314,6,0,0,0,0,1320,6,1
20077,20,077,2019,06,0,23,0,0,0,0,0,23,0,1
20079,20,079,2019,06,10140,5898,92,0,0,0,0,16130,10232,3
20083,20,083,2019,06,0,1657,12,0,0,0,0,1669,12,1
20084,20,084,2019,06,0,1610,0,0,0,0,0,1610,0,1
20090,20,090,2019,06,0,79,0,0,0,0,0,79,0,1
20091,20,091,2019,06,0,161,0,0,0,0,0,161,0,1
20096,20,096,2019,06,0,45,0,0,0,0,0,45,0,1
20107,20,107,2019,06,0,0,1,0,0,0,0,1,1,1
20115,20,115,2019,06,0,604,1,0,0,0,0,605,1,1
20131,20,131,2019,06,0,0,3,0,0,0,0,3,3,1
20134,20,134,2019,06,0,120,0,0,0,0,0,120,0,1
20136,20,136,2019,06,0,76,0,0,0,0,0,76,0,1
20143,20,143,2019,06,0,452,0,0,0,0,0,452,0,1
20166,20,166,2019,06,0,217,0,0,0,0,0,217,0,1
20174,20,174,2019,06,0,162,2,0,0,0,0,164,2,2
20177,20,177,2019,06,0,345,0,0,0,0,0,345,0,1
20179,20,179,2019,06,0,0,1,0,0,0,0,1,1,1
20184,20,184,2019,06,6167,11650,630,0,0,0,0,18447,6797,3
20185,20,185,2019,06,0,525,0,0,0,0,0,525,0,1
20188,20,188,2019,06,0,133,0,0,0,0,0,133,0,1
20190,20,190,2019,06,0,270,0,0,0,0,0,270,0,1
20227,20,227,2019,06,0,1077,0,0,0,0,0,1077,0,1
20232,20,232,2019,06,0,86,0,0,0,0,0,86,0,1
20242,20,242,2019,06,0,52,1,0,0,0,0,53,1,1
20275,20,275,2019,06,0,12,0,0,0,0,0,12,0,1
20277,20,277,2019,06,0,0,1,0,0,0,0,1,1,1
20278,20,278,2019,06,0,629,0,0,0,0,0,629,0,1
20293,20,293,2019,06,0,5,1,0,0,0,0,6,1,2
20294,20,294,2019,06,0,376,0,0,0,0,0,376,0,1
20295,20,295,2019,06,0,378,0,0,0,0,0,378,0,1
20298,20,298,2019,06,0,537,0,0,0,0,0,537,0,1
20300,20,300,2019,06,0,262,0,0,0,0,0,262,0,1
20305,20,305,2019,06,0,29,0,0,0,0,0,29,0,1
20309,20,309,2019,06,0,95,0,0,0,0,0,95,0,1
20310,20,310,2019,06,0,262,2,0,0,0,0,264,2,2
20318,20,318,2019,06,0,5894,137,0,0,0,0,6031,137,1
20324,20,324,2019,06,0,1873,0,0,0,0,0,1873,0,1
20327,20,327,2019,06,0,543,5,0,0,0,0,548,5,1
20334,20,334,2019,06,0,1711,0,0,0,0,0,1711,0,1
20338,20,338,2019,06,0,1035,2,0,0,0,0,1037,2,2
20339,20,339,2019,06,0,176,0,0,0,0,0,176,0,1
20342,20,342,2019,06,0,54,0,0,0,0,0,54,0,1
20356,20,356,2019,06,0,1,0,0,0,0,0,1,0,1
20360,20,360,2019,06,0,26,1,0,0,0,0,27,1,2
20364,20,364,2019,06,0,241,1,0,0,0,0,242,1,2
20375,20,375,2019,06,0,2991,1766,0,0,0,0,4757,1766,2
20380,20,380,2019,06,0,62,0,0,0,0,0,62,0,1
20382,20,382,2019,06,0,0,2,0,0,0,0,2,2,1
20384,20,384,2019,06,0,6,0,0,0,0,0,6,0,1
20385,20,385,2019,06,0,4826,175,0,0,0,0,5001,175,1
20387,20,387,2019,06,0,140,0,0,0,0,0,140,0,1
20393,20,393,2019,06,0,0,1,0,0,0,0,1,1,1
20397,20,397,2019,06,0,1785,29,0,0,0,0,1814,29,2
20398,20,398,2019,06,0,58,0,0,0,0,0,58,0,1
20399,20,399,2019,06,0,1639,1,0,0,0,0,1640,1,2
20401,20,401,2019,06,0,49,0,0,0,0,0,49,0,1
20409,20,409,2019,06,0,774,0,0,0,0,0,774,0,1
20413,20,413,2019,06,2828,4820,181,0,0,0,0,7829,3009,3
20414,20,414,2019,06,0,45,0,0,0,0,0,45,0,1
20418,20,418,2019,06,0,559,0,0,0,0,0,559,0,1
20421,20,421,2019,06,0,140,0,0,0,0,0,140,0,1
20427,20,427,2019,06,0,5,0,0,0,0,0,5,0,1
20431,20,431,2019,06,0,111,0,0,0,0,0,111,0,1
20437,20,437,2019,06,0,46,0,0,0,0,0,46,0,1
20447,20,447,2019,06,0,139,0,0,0,0,0,139,0,1
20452,20,452,2019,06,0,34,0,0,0,0,0,34,0,1
20459,20,459,2019,06,0,95,0,0,0,0,0,95,0,1
20467,20,467,2019,06,0,761,0,0,0,0,0,761,0,1
20469,20,469,2019,06,0,1326,0,0,0,0,0,1326,0,1
20475,20,475,2019,06,0,180,0,0,0,0,0,180,0,1
20482,20,482,2019,06,0,3823,50,0,0,0,0,3873,50,1
20505,20,505,2019,06,0,206,0,0,0,0,0,206,0,1
20515,20,515,2019,06,6949,1895,26,0,0,0,0,8870,6975,2
20517,20,517,2019,06,0,0,1,0,0,0,0,1,1,1
20519,20,519,2019,06,0,101,0,0,0,0,0,101,0,1
20520,20,520,2019,06,0,286,0,0,0,0,0,286,0,1
20523,20,523,2019,06,0,166,0,0,0,0,0,166,0,1
20525,20,525,2019,06,0,429,0,0,0,0,0,429,0,1
20537,20,537,2019,06,0,111,0,0,0,0,0,111,0,1
20539,20,539,2019,06,0,697,0,0,0,0,0,697,0,1
20540,20,540,2019,06,0,532,0,0,0,0,0,532,0,1
20545,20,545,2019,06,0,522,17,0,0,0,0,539,17,1
20546,20,546,2019,06,0,898,0,0,0,0,0,898,0,1
20549,20,549,2019,06,0,168,0,0,0,0,0,168,0,1
20551,20,551,2019,06,0,1159,126,0,0,0,0,1285,126,1
20553,20,553,2019,06,0,408,0,0,0,0,0,408,0,1
20557,20,557,2019,06,1658,634,0,0,0,0,0,2292,1658,2
20559,20,559,2019,06,0,254,1,0,0,0,0,255,1,2
20560,20,560,2019,06,0,2,0,0,0,0,0,2,0,1
20565,20,565,2019,06,0,1006,0,0,0,0,0,1006,0,1
20570,20,570,2019,06,0,4080,8,0,0,0,0,4088,8,2
21001,21,001,2019,06,0,2283,1,0,0,0,0,2284,1,2
21002,21,002,2019,06,0,1,0,0,0,0,0,1,0,1
21003,21,003,2019,06,0,2215,22,0,0,0,0,2237,22,1
21004,21,004,2019,06,3353,1693,0,0,0,0,0,5046,3353,2
21008,21,008,2019,06,0,341,0,0,0,0,0,341,0,1
21010,21,010,2019,06,5093,836,14,0,0,0,0,5943,5107,2
21011,21,011,2019,06,0,209,0,0,0,0,0,209,0,1
21012,21,012,2019,06,0,0,1,0,0,0,0,1,1,1
21013,21,013,2019,06,0,328,0,0,0,0,0,328,0,1
21014,21,014,2019,06,0,30,0,0,0,0,0,30,0,1
21015,21,015,2019,06,5575,2550,3577,0,0,0,0,11702,9152,3
21016,21,016,2019,06,0,119,0,0,0,0,0,119,0,1
21017,21,017,2019,06,0,2,0,0,0,0,0,2,0,1
21019,21,019,2019,06,0,14937,3912,0,0,0,0,18849,3912,1
21020,21,020,2019,06,0,376,0,0,0,0,0,376,0,1
21022,21,022,2019,06,0,144,0,0,0,0,0,144,0,1
21025,21,025,2019,06,0,154,0,0,0,0,0,154,0,1
21026,21,026,2019,06,0,813,1,0,0,0,0,814,1,2
21027,21,027,2019,06,0,1,0,0,0,0,0,1,0,1
21029,21,029,2019,06,0,34,0,0,0,0,0,34,0,1
21031,21,031,2019,06,0,32,0,0,0,0,0,32,0,1
21034,21,034,2019,06,0,3245,100,0,0,0,0,3345,100,2
21035,21,035,2019,06,0,327,0,0,0,0,0,327,0,1
21037,21,037,2019,06,0,1,0,0,0,0,0,1,0,1
21040,21,040,2019,06,0,35,0,0,0,0,0,35,0,1
21041,21,041,2019,06,15719,6655,1520,0,0,0,0,23894,17239,3
21042,21,042,2019,06,0,32,0,0,0,0,0,32,0,1
21043,21,043,2019,06,0,842,0,0,0,0,0,842,0,1
21044,21,044,2019,06,0,324,0,0,0,0,0,324,0,1
21045,21,045,2019,06,1247,1835,199,0,0,0,0,3281,1446,3
21047,21,047,2019,06,0,1460,0,0,0,0,0,1460,0,1
21048,21,048,2019,06,0,1134,0,0,0,0,0,1134,0,1
21051,21,051,2019,06,0,2457,1,0,0,0,0,2458,1,2
21053,21,053,2019,06,0,3058,164,0,0,0,0,3222,164,1
21054,21,054,2019,06,0,723,0,0,0,0,0,723,0,1
21055,21,055,2019,06,0,123,0,0,0,0,0,123,0,1
21056,21,056,2019,06,0,80,0,0,0,0,0,80,0,1
21058,21,058,2019,06,0,40,0,0,0,0,0,40,0,1
21059,21,059,2019,06,0,351,0,0,0,0,0,351,0,1
21060,21,060,2019,06,0,399,3,0,0,0,0,402,3,1
21062,21,062,2019,06,0,323,0,0,0,0,0,323,0,1
21063,21,063,2019,06,0,541,0,0,0,0,0,541,0,1
21065,21,065,2019,06,0,384,0,0,0,0,0,384,0,1
21066,21,066,2019,06,0,213,0,0,0,0,0,213,0,1
21067,21,067,2019,06,0,781,0,0,0,0,0,781,0,1
21069,21,069,2019,06,0,844,586,0,0,0,0,1430,586,1
21071,21,071,2019,06,0,6515,637,0,0,0,0,7152,637,1
21072,21,072,2019,06,0,57,0,0,0,0,0,57,0,1
21073,21,073,2019,06,0,543,0,0,0,0,0,543,0,1
21074,21,074,2019,06,3279,4783,2089,0,0,0,0,10151,5368,3
21075,21,075,2019,06,0,265,0,0,0,0,0,265,0,1
21076,21,076,2019,06,0,500,0,0,0,0,0,500,0,1
21082,21,082,2019,06,0,758,0,0,0,0,0,758,0,1
21083,21,083,2019,06,0,0,1,0,0,0,0,1,1,1
21085,21,085,2019,06,0,8385,565,0,0,0,0,8950,565,1
21086,21,086,2019,06,0,0,1,0,0,0,0,1,1,1
21087,21,087,2019,06,0,201,0,0,0,0,0,201,0,1
21090,21,090,2019,06,0,0,12,0,0,0,0,12,12,1
21091,21,091,2019,06,0,1625,83,0,0,0,0,1708,83,1
21094,21,094,2019,06,0,1840,0,0,0,0,0,1840,0,1
21099,21,099,2019,06,0,262,0,0,0,0,0,262,0,1
21102,21,102,2019,06,0,473,0,0,0,0,0,473,0,1
21103,21,103,2019,06,0,201,0,0,0,0,0,201,0,1
21104,21,104,2019,06,0,19,0,0,0,0,0,19,0,1
21105,21,105,2019,06,0,297,0,0,0,0,0,297,0,1
21106,21,106,2019,06,0,770,1,0,0,0,0,771,1,2
21108,21,108,2019,06,0,735,97,0,0,0,0,832,97,1
21109,21,109,2019,06,0,94,0,0,0,0,0,94,0,1
21110,21,110,2019,06,0,507,0,0,0,0,0,507,0,1
21111,21,111,2019,06,0,239,0,0,0,0,0,239,0,1
21112,21,112,2019,06,0,222,0,0,0,0,0,222,0,1
21114,21,114,2019,06,151052,97113,125517,0,0,0,0,373682,276569,3
21115,21,115,2019,06,0,933,0,0,0,0,0,933,0,1
21117,21,117,2019,06,0,1570,205,0,0,0,0,1775,205,2
21118,21,118,2019,06,0,467,85,0,0,0,0,552,85,1
21119,21,119,2019,06,18376,9239,16119,0,0,0,0,43734,34495,3
21122,21,122,2019,06,0,1203,148,0,0,0,0,1351,148,1
21124,21,124,2019,06,0,653,0,0,0,0,0,653,0,1
21125,21,125,2019,06,0,1178,206,0,0,0,0,1384,206,1
21128,21,128,2019,06,1377,206,23,0,0,0,0,1606,1400,2
21129,21,129,2019,06,0,24,0,0,0,0,0,24,0,1
21130,21,130,2019,06,0,5,0,0,0,0,0,5,0,1
21132,21,132,2019,06,2237,12438,1278,0,0,0,0,15953,3515,4
21133,21,133,2019,06,0,2,0,0,0,0,0,2,0,1
21134,21,134,2019,06,0,1268,0,0,0,0,0,1268,0,1
21136,21,136,2019,06,0,1260,60,0,0,0,0,1320,60,2
21138,21,138,2019,06,0,290,0,0,0,0,0,290,0,1
21139,21,139,2019,06,0,148,0,0,0,0,0,148,0,1
21140,21,140,2019,06,0,14601,3716,0,0,0,0,18317,3716,2
21142,21,142,2019,06,1653,535,0,0,0,0,0,2188,1653,2
21143,21,143,2019,06,0,1648,0,0,0,0,0,1648,0,1
21144,21,144,2019,06,0,733,203,0,0,0,0,936,203,1
21147,21,147,2019,06,0,108,0,0,0,0,0,108,0,1
21148,21,148,2019,06,0,354,0,0,0,0,0,354,0,1
21149,21,149,2019,06,0,516,1,0,0,0,0,517,1,2
21151,21,151,2019,06,0,166,0,0,0,0,0,166,0,1
21153,21,153,2019,06,335,483,0,0,0,0,0,818,335,2
21154,21,154,2019,06,5078,3381,323,0,0,0,0,8782,5401,3
21155,21,155,2019,06,0,379,0,0,0,0,0,379,0,1
21156,21,156,2019,06,26127,21143,3629,0,0,0,0,50899,29756,3
21157,21,157,2019,06,0,516,0,0,0,0,0,516,0,1
21159,21,159,2019,06,0,83,0,0,0,0,0,83,0,1
21160,21,160,2019,06,0,14,0,0,0,0,0,14,0,1
21161,21,161,2019,06,0,324,0,0,0,0,0,324,0,1
21163,21,163,2019,06,1232,599,0,0,0,0,0,1831,1232,2
21164,21,164,2019,06,4494,3111,174,0,0,0,0,7779,4668,2
21166,21,166,2019,06,0,614,0,0,0,0,0,614,0,1
21168,21,168,2019,06,0,144,0,0,0,0,0,144,0,1
21169,21,169,2019,06,0,632,0,0,0,0,0,632,0,1
21170,21,170,2019,06,0,330,0,0,0,0,0,330,0,1
21172,21,172,2019,06,0,849,0,0,0,0,0,849,0,1
21173,21,173,2019,06,0,1562,1,0,0,0,0,1563,1,1
21174,21,174,2019,06,0,10157,609,0,0,0,0,10766,609,1
21175,21,175,2019,06,0,369,0,0,0,0,0,369,0,1
21176,21,176,2019,06,0,0,221,0,0,0,0,221,221,1
21177,21,177,2019,06,1163,471,0,0,0,0,0,1634,1163,2
21179,21,179,2019,06,0,145,0,0,0,0,0,145,0,1
21180,21,180,2019,06,0,605,25,0,0,0,0,630,25,1
21181,21,181,2019,06,0,623,0,0,0,0,0,623,0,1
21183,21,183,2019,06,0,3,0,0,0,0,0,3,0,1
21185,21,185,2019,06,0,499,0,0,0,0,0,499,0,1
21186,21,186,2019,06,0,1606,0,0,0,0,0,1606,0,1
21188,21,188,2019,06,0,577,0,0,0,0,0,577,0,1
21189,21,189,2019,06,0,426,0,0,0,0,0,426,0,1
21191,21,191,2019,06,0,687,0,0,0,0,0,687,0,1
21194,21,194,2019,06,0,1731,0,0,0,0,0,1731,0,1
21195,21,195,2019,06,0,33,0,0,0,0,0,33,0,1
21197,21,197,2019,06,0,4963,233,0,0,0,0,5196,233,2
21199,21,199,2019,06,0,264,0,0,0,0,0,264,0,1
21201,21,201,2019,06,0,95,0,0,0,0,0,95,0,1
21203,21,203,2019,06,0,1,0,0,0,0,0,1,0,1
21205,21,205,2019,06,0,714,0,0,0,0,0,714,0,1
21207,21,207,2019,06,0,2239,6,0,0,0,0,2245,6,1
21208,21,208,2019,06,0,5881,286,0,0,0,0,6167,286,1
21209,21,209,2019,06,0,244,0,0,0,0,0,244,0,1
21210,21,210,2019,06,0,8,0,0,0,0,0,8,0,1
21211,21,211,2019,06,0,1392,0,0,0,0,0,1392,0,1
21214,21,214,2019,06,0,304,0,0,0,0,0,304,0,1
21217,21,217,2019,06,0,67,0,0,0,0,0,67,0,1
22001,22,001,2019,06,0,1513,3,0,0,0,0,1516,3,1
22002,22,002,2019,06,0,137,0,0,0,0,0,137,0,1
22003,22,003,2019,06,0,216,0,0,0,0,0,216,0,1
22004,22,004,2019,06,904,1835,47,0,0,0,0,2786,951,2
22005,22,005,2019,06,0,403,0,0,0,0,0,403,0,1
22006,22,006,2019,06,21593,5671,4767,0,0,0,0,32031,26360,3
22007,22,007,2019,06,0,2089,117,0,0,0,0,2206,117,1
22008,22,008,2019,06,0,345,87,0,0,0,0,432,87,1
22009,22,009,2019,06,0,1412,0,0,0,0,0,1412,0,1
22010,22,010,2019,06,0,128,0,0,0,0,0,128,0,1
22011,22,011,2019,06,0,2578,862,0,0,0,0,3440,862,2
22012,22,012,2019,06,0,2213,119,0,0,0,0,2332,119,2
22013,22,013,2019,06,0,189,0,0,0,0,0,189,0,1
22014,22,014,2019,06,249671,66065,64882,0,0,0,0,380618,314553,4
22015,22,015,2019,06,0,90,0,0,0,0,0,90,0,1
22016,22,016,2019,06,15223,14632,6493,0,0,0,0,36348,21716,4
22017,22,017,2019,06,0,1854,2490,0,0,0,0,4344,2490,2
22018,22,018,2019,06,0,318,1,0,0,0,0,319,1,2
23001,23,001,2019,06,7176,11293,601,0,0,0,0,19070,7777,3
23002,23,002,2019,06,0,1586,1,0,0,0,0,1587,1,2
23003,23,003,2019,06,2254,1310,9,0,0,0,0,3573,2263,3
23004,23,004,2019,06,15520,14255,1032,0,0,0,0,30807,16552,3
23005,23,005,2019,06,86321,42000,58538,0,0,0,0,186859,144859,3
23006,23,006,2019,06,0,342,170,0,0,0,0,512,170,1
23007,23,007,2019,06,0,680,23,0,0,0,0,703,23,2
23008,23,008,2019,06,30166,20694,9999,0,0,0,0,60859,40165,3
23009,23,009,2019,06,3206,2280,1763,0,0,0,0,7249,4969,2
23010,23,010,2019,06,0,0,2,0,0,0,0,2,2,1
24001,24,001,2019,06,0,422,0,0,0,0,0,422,0,1
24003,24,003,2019,06,0,240,0,0,0,0,0,240,0,1
24005,24,005,2019,06,0,1301,0,0,0,0,0,1301,0,1
24006,24,006,2019,06,0,289,0,0,0,0,0,289,0,1
24007,24,007,2019,06,0,1286,0,0,0,0,0,1286,0,1
24008,24,008,2019,06,0,1826,0,0,0,0,0,1826,0,1
24010,24,010,2019,06,0,698,0,0,0,0,0,698,0,1
24011,24,011,2019,06,0,0,123,0,0,0,0,123,123,1
24012,24,012,2019,06,0,453,0,0,0,0,0,453,0,1
24013,24,013,2019,06,12392,11821,255,0,0,0,0,24468,12647,2
24015,24,015,2019,06,0,1250,1,0,0,0,0,1251,1,2
24016,24,016,2019,06,0,2093,0,0,0,0,0,2093,0,1
24017,24,017,2019,06,0,82,0,0,0,0,0,82,0,1
24018,24,018,2019,06,0,285,0,0,0,0,0,285,0,1
24020,24,020,2019,06,4779,4762,4173,0,0,0,0,13714,8952,3
24021,24,021,2019,06,0,868,256,0,0,0,0,1124,256,1
24022,24,022,2019,06,0,618,0,0,0,0,0,618,0,1
24023,24,023,2019,06,0,835,0,0,0,0,0,835,0,1
24024,24,024,2019,06,0,8510,1882,0,0,0,0,10392,1882,1
24025,24,025,2019,06,0,1827,0,0,0,0,0,1827,0,1
24027,24,027,2019,06,0,687,0,0,0,0,0,687,0,1
24028,24,028,2019,06,40920,70246,81959,0,0,0,0,193125,122879,3
24029,24,029,2019,06,0,183,0,0,0,0,0,183,0,1
24032,24,032,2019,06,0,1002,1,0,0,0,0,1003,1,2
24035,24,035,2019,06,11985,6303,15800,0,0,0,0,34088,27785,3
24036,24,036,2019,06,0,987,0,0,0,0,0,987,0,1
24037,24,037,2019,06,0,3587,133,0,0,0,0,3720,133,1
24039,24,039,2019,06,0,268,0,0,0,0,0,268,0,1
24040,24,040,2019,06,0,1704,0,0,0,0,0,1704,0,1
24042,24,042,2019,06,0,819,0,0,0,0,0,819,0,1
24043,24,043,2019,06,0,57,0,0,0,0,0,57,0,1
24044,24,044,2019,06,0,179,0,0,0,0,0,179,0,1
24045,24,045,2019,06,0,681,0,0,0,0,0,681,0,1
24046,24,046,2019,06,0,319,0,0,0,0,0,319,0,1
24048,24,048,2019,06,0,342,0,0,0,0,0,342,0,1
24049,24,049,2019,06,0,1553,0,0,0,0,0,1553,0,1
24050,24,050,2019,06,0,1088,0,0,0,0,0,1088,0,1
24051,24,051,2019,06,0,363,0,0,0,0,0,363,0,1
24053,24,053,2019,06,0,916,0,0,0,0,0,916,0,1
24054,24,054,2019,06,0,973,0,0,0,0,0,973,0,1
24055,24,055,2019,06,0,599,0,0,0,0,0,599,0,1
24056,24,056,2019,06,0,218,0,0,0,0,0,218,0,1
24057,24,057,2019,06,0,618,0,0,0,0,0,618,0,1
24058,24,058,2019,06,0,489,0,0,0,0,0,489,0,1
25001,25,001,2019,06,48231,19975,11414,0,0,0,0,79620,59645,3
25002,25,002,2019,06,2507,1325,0,0,0,0,0,3832,2507,2
25003,25,003,2019,06,0,209,0,0,0,0,0,209,0,1
25004,25,004,2019,06,1139,709,2,0,0,0,0,1850,1141,3
25005,25,005,2019,06,0,597,0,0,0,0,0,597,0,1
25006,25,006,2019,06,114037,66991,12201,0,0,0,0,193229,126238,3
25007,25,007,2019,06,992,278,0,0,0,0,0,1270,992,2
25008,25,008,2019,06,0,2345,1,0,0,0,0,2346,1,2
25009,25,009,2019,06,4602,2423,0,0,0,0,0,7025,4602,2
25010,25,010,2019,06,2188,1663,0,0,0,0,0,3851,2188,2
25011,25,011,2019,06,23035,11457,567,0,0,0,0,35059,23602,2
25012,25,012,2019,06,56228,40690,11653,0,0,0,0,108571,67881,3
25013,25,013,2019,06,1358,793,0,0,0,0,0,2151,1358,2
25014,25,014,2019,06,2815,1508,0,0,0,0,0,4323,2815,2
25015,25,015,2019,06,8537,5390,166,0,0,0,0,14093,8703,2
25016,25,016,2019,06,0,504,0,0,0,0,0,504,0,1
25017,25,017,2019,06,0,976,0,0,0,0,0,976,0,1
25018,25,018,2019,06,4565,3458,118,0,0,0,0,8141,4683,3
26001,26,001,2019,06,0,245,0,0,0,0,0,245,0,1
26002,26,002,2019,06,15008,4907,206,0,0,0,0,20121,15214,3
26003,26,003,2019,06,0,1382,0,0,0,0,0,1382,0,1
26004,26,004,2019,06,1474,478,0,0,0,0,0,1952,1474,2
26005,26,005,2019,06,0,46,0,0,0,0,0,46,0,1
26006,26,006,2019,06,0,148,0,0,0,0,0,148,0,1
26009,26,009,2019,06,0,72,0,0,0,0,0,72,0,1
26010,26,010,2019,06,0,79,0,0,0,0,0,79,0,1
26012,26,012,2019,06,0,487,0,0,0,0,0,487,0,1
26013,26,013,2019,06,0,221,0,0,0,0,0,221,0,1
26014,26,014,2019,06,0,200,0,0,0,0,0,200,0,1
26016,26,016,2019,06,0,727,0,0,0,0,0,727,0,1
26017,26,017,2019,06,8619,6214,766,0,0,0,0,15599,9385,2
26018,26,018,2019,06,55392,24598,5240,0,0,0,0,85230,60632,3
26019,26,019,2019,06,4968,4862,0,0,0,0,0,9830,4968,2
26020,26,020,2019,06,0,294,0,0,0,0,0,294,0,1
26023,26,023,2019,06,0,735,0,0,0,0,0,735,0,1
26025,26,025,2019,06,4957,3329,0,0,0,0,0,8286,4957,2
26026,26,026,2019,06,0,1395,0,0,0,0,0,1395,0,1
26027,26,027,2019,06,0,1188,0,0,0,0,0,1188,0,1
26029,26,029,2019,06,16595,12410,2132,0,0,0,0,31137,18727,2
26030,26,030,2019,06,113698,59167,29704,0,0,0,0,202569,143402,3
26032,26,032,2019,06,0,94,0,0,0,0,0,94,0,1
26033,26,033,2019,06,3057,3182,0,0,0,0,0,6239,3057,2
26034,26,034,2019,06,0,150,0,0,0,0,0,150,0,1
26035,26,035,2019,06,0,1007,0,0,0,0,0,1007,0,1
26036,26,036,2019,06,3899,3321,21,0,0,0,0,7241,3920,2
26037,26,037,2019,06,0,48,0,0,0,0,0,48,0,1
26038,26,038,2019,06,0,848,0,0,0,0,0,848,0,1
26039,26,039,2019,06,0,966,0,0,0,0,0,966,0,1
26041,26,041,2019,06,1709,1711,0,0,0,0,0,3420,1709,2
26042,26,042,2019,06,11402,9378,295,0,0,0,0,21075,11697,3
26043,26,043,2019,06,42500,12205,2097,0,0,0,0,56802,44597,3
26045,26,045,2019,06,0,58,0,0,0,0,0,58,0,1
26047,26,047,2019,06,0,494,0,0,0,0,0,494,0,1
26048,26,048,2019,06,8407,8514,1450,0,0,0,0,18371,9857,3
26050,26,050,2019,06,0,50,0,0,0,0,0,50,0,1
26051,26,051,2019,06,0,120,0,0,0,0,0,120,0,1
26052,26,052,2019,06,0,411,0,0,0,0,0,411,0,1
26053,26,053,2019,06,0,7,0,0,0,0,0,7,0,1
26055,26,055,2019,06,24359,10570,7031,0,0,0,0,41960,31390,2
26056,26,056,2019,06,0,217,0,0,0,0,0,217,0,1
26057,26,057,2019,06,0,150,0,0,0,0,0,150,0,1
26058,26,058,2019,06,1717,1312,40,0,0,0,0,3069,1757,2
26059,26,059,2019,06,0,130,0,0,0,0,0,130,0,1
26062,26,062,2019,06,0,28,0,0,0,0,0,28,0,1
26063,26,063,2019,06,0,116,0,0,0,0,0,116,0,1
26064,26,064,2019,06,0,48,0,0,0,0,0,48,0,1
26066,26,066,2019,06,0,895,0,0,0,0,0,895,0,1
26067,26,067,2019,06,0,158,0,0,0,0,0,158,0,1
26068,26,068,2019,06,0,24,0,0,0,0,0,24,0,1
26069,26,069,2019,06,0,205,0,0,0,0,0,205,0,1
26070,26,070,2019,06,0,1445,1,0,0,0,0,1446,1,1
26071,26,071,2019,06,1318,630,0,0,0,0,0,1948,1318,2
26072,26,072,2019,06,0,296,0,0,0,0,0,296,0,1
27001,27,001,2019,06,0,972,4,0,0,0,0,976,4,1
27002,27,002,2019,06,5685,9340,115,0,0,0,0,15140,5800,3
27003,27,003,2019,06,0,2178,16,0,0,0,0,2194,16,1
27004,27,004,2019,06,31655,49567,25182,0,0,0,0,106404,56837,3
27005,27,005,2019,06,2968,6829,155,0,0,0,0,9952,3123,3
27006,27,006,2019,06,0,2376,58,0,0,0,0,2434,58,2
27007,27,007,2019,06,0,1930,15,0,0,0,0,1945,15,1
27008,27,008,2019,06,0,3358,312,0,0,0,0,3670,312,1
27009,27,009,2019,06,0,426,0,0,0,0,0,426,0,1
27010,27,010,2019,06,0,1776,19,0,0,0,0,1795,19,1
27011,27,011,2019,06,0,434,0,0,0,0,0,434,0,1
27012,27,012,2019,06,0,6333,150,0,0,0,0,6483,150,1
27013,27,013,2019,06,0,2853,326,0,0,0,0,3179,326,2
27014,27,014,2019,06,1666,4280,555,0,0,0,0,6501,2221,2
27015,27,015,2019,06,0,566,1,0,0,0,0,567,1,2
27016,27,016,2019,06,0,2560,250,0,0,0,0,2810,250,1
27017,27,017,2019,06,0,2961,10,0,0,0,0,2971,10,1
28001,28,001,2019,06,0,576,0,0,0,0,0,576,0,1
28002,28,002,2019,06,0,1226,0,0,0,0,0,1226,0,1
28003,28,003,2019,06,19478,12372,3496,0,0,0,0,35346,22974,3
28004,28,004,2019,06,0,375,0,0,0,0,0,375,0,1
28005,28,005,2019,06,0,53,0,0,0,0,0,53,0,1
28007,28,007,2019,06,0,1673,7,0,0,0,0,1680,7,1
28009,28,009,2019,06,0,19227,3447,0,0,0,0,22674,3447,2
28011,28,011,2019,06,0,235,0,0,0,0,0,235,0,1
28012,28,012,2019,06,0,2382,0,0,0,0,0,2382,0,1
28013,28,013,2019,06,0,27,0,0,0,0,0,27,0,1
28014,28,014,2019,06,0,487,0,0,0,0,0,487,0,1
28015,28,015,2019,06,0,1982,0,0,0,0,0,1982,0,1
28016,28,016,2019,06,0,480,0,0,0,0,0,480,0,1
28017,28,017,2019,06,0,650,0,0,0,0,0,650,0,1
28018,28,018,2019,06,0,530,0,0,0,0,0,530,0,1
28019,28,019,2019,06,0,473,0,0,0,0,0,473,0,1
28020,28,020,2019,06,0,33,0,0,0,0,0,33,0,1
28021,28,021,2019,06,8386,8423,650,0,0,0,0,17459,9036,2
28022,28,022,2019,06,0,49390,10347,0,0,0,0,59737,10347,1
28023,28,023,2019,06,0,38,0,0,0,0,0,38,0,1
28024,28,024,2019,06,0,671,0,0,0,0,0,671,0,1
28025,28,025,2019,06,0,4617,0,0,0,0,0,4617,0,1
28026,28,026,2019,06,0,153,0,0,0,0,0,153,0,1
28027,28,027,2019,06,18799,42212,7441,0,0,0,0,68452,26240,3
28029,28,029,2019,06,0,128,0,0,0,0,0,128,0,1
28030,28,030,2019,06,0,951,0,0,0,0,0,951,0,1
28031,28,031,2019,06,0,126,0,0,0,0,0,126,0,1
28032,28,032,2019,06,43723,58014,12193,0,0,0,0,113930,55916,3
28033,28,033,2019,06,0,12793,2126,0,0,0,0,14919,2126,1
28035,28,035,2019,06,0,4115,13,0,0,0,0,4128,13,1
28037,28,037,2019,06,0,1606,0,0,0,0,0,1606,0,1
28038,28,038,2019,06,46190,50313,6551,0,0,0,0,103054,52741,3
28039,28,039,2019,06,0,915,0,0,0,0,0,915,0,1
28040,28,040,2019,06,0,6795,38,0,0,0,0,6833,38,1
28041,28,041,2019,06,0,26375,3664,0,0,0,0,30039,3664,2
28042,28,042,2019,06,0,122,0,0,0,0,0,122,0,1
28043,28,043,2019,06,0,1324,0,0,0,0,0,1324,0,1
29001,29,001,2019,06,0,1789,763,0,0,0,0,2552,763,1
29002,29,002,2019,06,0,8,0,0,0,0,0,8,0,1
29004,29,004,2019,06,0,71,0,0,0,0,0,71,0,1
29005,29,005,2019,06,6881,11319,2267,0,0,0,0,20467,9148,3
29006,29,006,2019,06,0,3511,5,0,0,0,0,3516,5,1
29007,29,007,2019,06,0,782,0,0,0,0,0,782,0,1
29008,29,008,2019,06,0,505,0,0,0,0,0,505,0,1
29010,29,010,2019,06,0,7999,263,0,0,0,0,8262,263,1
29011,29,011,2019,06,0,212,0,0,0,0,0,212,0,1
29013,29,013,2019,06,2356,5021,432,0,0,0,0,7809,2788,2
29014,29,014,2019,06,0,938,0,0,0,0,0,938,0,1
29015,29,015,2019,06,0,1465,165,0,0,0,0,1630,165,1
29016,29,016,2019,06,0,378,111,0,0,0,0,489,111,1
29017,29,017,2019,06,0,679,605,0,0,0,0,1284,605,1
29018,29,018,2019,06,0,15,0,0,0,0,0,15,0,1
29019,29,019,2019,06,0,1578,0,0,0,0,0,1578,0,1
29020,29,020,2019,06,0,269,0,0,0,0,0,269,0,1
29021,29,021,2019,06,0,1232,7,0,0,0,0,1239,7,1
29022,29,022,2019,06,0,118,19,0,0,0,0,137,19,1
29023,29,023,2019,06,0,2567,4,0,0,0,0,2571,4,1
29024,29,024,2019,06,0,2061,225,0,0,0,0,2286,225,1
29025,29,025,2019,06,0,2900,2050,0,0,0,0,4950,2050,2
29026,29,026,2019,06,0,107,0,0,0,0,0,107,0,1
29027,29,027,2019,06,0,614,577,0,0,0,0,1191,577,1
29028,29,028,2019,06,4467,1189,2,0,0,0,0,5658,4469,2
29029,29,029,2019,06,0,7,4,0,0,0,0,11,4,1
29030,29,030,2019,06,0,144,0,0,0,0,0,144,0,1
29031,29,031,2019,06,0,2054,293,0,0,0,0,2347,293,1
29032,29,032,2019,06,0,17,0,0,0,0,0,17,0,1
29033,29,033,2019,06,23894,10129,3776,0,0,0,0,37799,27670,3
29034,29,034,2019,06,0,1518,3,0,0,0,0,1521,3,1
29035,29,035,2019,06,0,1,0,0,0,0,0,1,0,1
29036,29,036,2019,06,0,13,14,0,0,0,0,27,14,1
29037,29,037,2019,06,0,343,0,0,0,0,0,343,0,1
29038,29,038,2019,06,0,578,0,0,0,0,0,578,0,1
29039,29,039,2019,06,0,1637,61,0,0,0,0,1698,61,1
29040,29,040,2019,06,0,550,0,0,0,0,0,550,0,1
29041,29,041,2019,06,0,3757,524,0,0,0,0,4281,524,1
29042,29,042,2019,06,0,1572,0,0,0,0,0,1572,0,1
29043,29,043,2019,06,0,859,108,0,0,0,0,967,108,1
29044,29,044,2019,06,1835,4273,2926,0,0,0,0,9034,4761,2
29045,29,045,2019,06,0,811,0,0,0,0,0,811,0,1
29048,29,048,2019,06,0,1457,0,0,0,0,0,1457,0,1
29049,29,049,2019,06,0,433,0,0,0,0,0,433,0,1
29050,29,050,2019,06,0,883,0,0,0,0,0,883,0,1
29055,29,055,2019,06,0,1,0,0,0,0,0,1,0,1
29056,29,056,2019,06,0,801,28,0,0,0,0,829,28,1
29057,29,057,2019,06,0,1,0,0,0,0,0,1,0,1
30001,30,001,2019,06,0,91,0,0,0,0,0,91,0,1
30002,30,002,2019,06,0,168,0,0,0,0,0,168,0,1
30003,30,003,2019,06,0,7952,56,0,0,0,0,8008,56,1
30004,30,004,2019,06,0,1711,0,0,0,0,0,1711,0,1
30005,30,005,2019,06,0,84,0,0,0,0,0,84,0,1
30006,30,006,2019,06,0,11,0,0,0,0,0,11,0,1
30007,30,007,2019,06,0,186,0,0,0,0,0,186,0,1
30009,30,009,2019,06,0,814,0,0,0,0,0,814,0,1
30010,30,010,2019,06,1397,1555,10,0,0,0,0,2962,1407,2
30011,30,011,2019,06,0,4972,1242,0,0,0,0,6214,1242,1
30012,30,012,2019,06,0,144,0,0,0,0,0,144,0,1
30013,30,013,2019,06,0,4339,39,0,0,0,0,4378,39,2
30014,30,014,2019,06,0,1682,905,0,0,0,0,2587,905,1
30015,30,015,2019,06,0,1004,0,0,0,0,0,1004,0,1
30016,30,016,2019,06,3902,2893,452,0,0,0,0,7247,4354,2
30018,30,018,2019,06,0,2,0,0,0,0,0,2,0,1
30021,30,021,2019,06,0,1970,0,0,0,0,0,1970,0,1
30022,30,022,2019,06,0,658,0,0,0,0,0,658,0,1
30024,30,024,2019,06,0,1,0,0,0,0,0,1,0,1
30025,30,025,2019,06,0,10,0,0,0,0,0,10,0,1
30026,30,026,2019,06,6275,975,630,0,0,0,0,7880,6905,3
30028,30,028,2019,06,0,5519,13776,0,0,0,0,19295,13776,2
30030,30,030,2019,06,2309,3819,91,0,0,0,0,6219,2400,3
30032,30,032,2019,06,0,2639,76,0,0,0,0,2715,76,1
30033,30,033,2019,06,0,410,0,0,0,0,0,410,0,1
30034,30,034,2019,06,0,3766,189,0,0,0,0,3955,189,1
30035,30,035,2019,06,0,293,0,0,0,0,0,293,0,1
30036,30,036,2019,06,0,154,0,0,0,0,0,154,0,1
30038,30,038,2019,06,10044,7611,1525,0,0,0,0,19180,11569,3
30039,30,039,2019,06,32202,25731,4387,0,0,0,0,62320,36589,3
30040,30,040,2019,06,4142,2419,284,0,0,0,0,6845,4426,2
30042,30,042,2019,06,0,114,0,0,0,0,0,114,0,1
30043,30,043,2019,06,0,73,0,0,0,0,0,73,0,1
30044,30,044,2019,06,20110,17018,2628,0,0,0,0,39756,22738,3
30045,30,045,2019,06,3699,2632,282,0,0,0,0,6613,3981,2
30046,30,046,2019,06,0,143,0,0,0,0,0,143,0,1
30047,30,047,2019,06,0,1750,4,0,0,0,0,1754,4,1
30048,30,048,2019,06,6887,2970,24,0,0,0,0,9881,6911,2
30049,30,049,2019,06,0,264,0,0,0,0,0,264,0,1
30051,30,051,2019,06,0,656,0,0,0,0,0,656,0,1
30052,30,052,2019,06,0,289,0,0,0,0,0,289,0,1
30053,30,053,2019,06,0,2182,15,0,0,0,0,2197,15,2
30054,30,054,2019,06,0,428,0,0,0,0,0,428,0,1
30055,30,055,2019,06,0,262,0,0,0,0,0,262,0,1
30057,30,057,2019,06,0,251,0,0,0,0,0,251,0,1
30058,30,058,2019,06,0,754,3,0,0,0,0,757,3,2
30059,30,059,2019,06,0,1000,0,0,0,0,0,1000,0,1
30060,30,060,2019,06,0,43,0,0,0,0,0,43,0,1
30061,30,061,2019,06,0,4585,6,0,0,0,0,4591,6,2
30062,30,062,2019,06,0,543,1,0,0,0,0,544,1,1
30063,30,063,2019,06,0,217,0,0,0,0,0,217,0,1
30065,30,065,2019,06,2155,2815,190,0,0,0,0,5160,2345,3
30066,30,066,2019,06,0,450,0,0,0,0,0,450,0,1
30068,30,068,2019,06,5042,4842,548,0,0,0,0,10432,5590,2
30069,30,069,2019,06,2159,1477,3,0,0,0,0,3639,2162,2
30070,30,070,2019,06,0,62,0,0,0,0,0,62,0,1
30071,30,071,2019,06,0,4012,107,0,0,0,0,4119,107,2
30072,30,072,2019,06,0,485,0,0,0,0,0,485,0,1
30073,30,073,2019,06,0,1154,0,0,0,0,0,1154,0,1
30075,30,075,2019,06,0,203,0,0,0,0,0,203,0,1
30077,30,077,2019,06,2164,2242,61,0,0,0,0,4467,2225,2
30078,30,078,2019,06,0,257,0,0,0,0,0,257,0,1
30080,30,080,2019,06,0,327,0,0,0,0,0,327,0,1
30081,30,081,2019,06,0,377,10,0,0,0,0,387,10,1
30082,30,082,2019,06,0,1212,0,0,0,0,0,1212,0,1
30084,30,084,2019,06,0,0,203,0,0,0,0,203,203,1
30085,30,085,2019,06,0,3763,58,0,0,0,0,3821,58,2
30086,30,086,2019,06,1411,839,2,0,0,0,0,2252,1413,2
30087,30,087,2019,06,48911,39184,39716,0,0,0,0,127811,88627,3
30088,30,088,2019,06,915,74,0,0,0,0,0,989,915,2
30089,30,089,2019,06,1379,2647,2,0,0,0,0,4028,1381,2
30090,30,090,2019,06,0,232,0,0,0,0,0,232,0,1
30091,30,091,2019,06,0,1204,0,0,0,0,0,1204,0,1
30092,30,092,2019,06,0,2008,17,0,0,0,0,2025,17,1
30093,30,093,2019,06,0,399,0,0,0,0,0,399,0,1
30094,30,094,2019,06,0,1080,1,0,0,0,0,1081,1,1
30095,30,095,2019,06,0,195,0,0,0,0,0,195,0,1
30097,30,097,2019,06,0,2840,20,0,0,0,0,2860,20,1
30099,30,099,2019,06,0,809,0,0,0,0,0,809,0,1
30100,30,100,2019,06,1335,342,8,0,0,0,0,1685,1343,2
30101,30,101,2019,06,0,5131,316,0,0,0,0,5447,316,1
30102,30,102,2019,06,4209,10633,288,0,0,0,0,15130,4497,2
30104,30,104,2019,06,0,133,0,0,0,0,0,133,0,1
30105,30,105,2019,06,10409,2139,893,0,0,0,0,13441,11302,3
30108,30,108,2019,06,13646,15058,539,0,0,0,0,29243,14185,3
30109,30,109,2019,06,0,3507,4,0,0,0,0,3511,4,2
30111,30,111,2019,06,0,851,0,0,0,0,0,851,0,1
30112,30,112,2019,06,0,725,1,0,0,0,0,726,1,1
30113,30,113,2019,06,0,284,1,0,0,0,0,285,1,1
30114,30,114,2019,06,0,411,0,0,0,0,0,411,0,1
30115,30,115,2019,06,0,17,0,0,0,0,0,17,0,1
30116,30,116,2019,06,0,1319,0,0,0,0,0,1319,0,1
30117,30,117,2019,06,0,880,0,0,0,0,0,880,0,1
30118,30,118,2019,06,16807,16041,1350,0,0,0,0,34198,18157,3
30119,30,119,2019,06,0,368,0,0,0,0,0,368,0,1
30121,30,121,2019,06,0,442,0,0,0,0,0,442,0,1
30123,30,123,2019,06,0,6707,684,0,0,0,0,7391,684,1
30124,30,124,2019,06,5924,5836,64,0,0,0,0,11824,5988,2
30125,30,125,2019,06,0,1131,7,0,0,0,0,1138,7,1
30126,30,126,2019,06,1324,793,7,0,0,0,0,2124,1331,2
30128,30,128,2019,06,6813,3003,270,0,0,0,0,10086,7083,2
30129,30,129,2019,06,0,839,0,0,0,0,0,839,0,1
30130,30,130,2019,06,0,1268,52,0,0,0,0,1320,52,1
30131,30,131,2019,06,20990,16272,3669,0,0,0,0,40931,24659,2
30132,30,132,2019,06,0,347,255,0,0,0,0,602,255,1
30133,30,133,2019,06,0,3899,0,0,0,0,0,3899,0,1
30134,30,134,2019,06,0,372,0,0,0,0,0,372,0,1
30135,30,135,2019,06,0,1142,0,0,0,0,0,1142,0,1
30136,30,136,2019,06,0,275,6,0,0,0,0,281,6,1
30138,30,138,2019,06,3980,5074,74,0,0,0,0,9128,4054,2
30139,30,139,2019,06,0,379,0,0,0,0,0,379,0,1
30141,30,141,2019,06,0,8449,411,0,0,0,0,8860,411,2
30142,30,142,2019,06,0,581,0,0,0,0,0,581,0,1
30143,30,143,2019,06,0,1514,9,0,0,0,0,1523,9,1
30144,30,144,2019,06,0,801,0,0,0,0,0,801,0,1
30145,30,145,2019,06,0,778,0,0,0,0,0,778,0,1
30147,30,147,2019,06,0,14,0,0,0,0,0,14,0,1
30148,30,148,2019,06,0,1134,8,0,0,0,0,1142,8,1
30149,30,149,2019,06,0,0,2,0,0,0,0,2,2,1
30150,30,150,2019,06,0,425,0,0,0,0,0,425,0,1
30151,30,151,2019,06,0,501,0,0,0,0,0,501,0,1
30152,30,152,2019,06,0,296,0,0,0,0,0,296,0,1
30154,30,154,2019,06,0,35,0,0,0,0,0,35,0,1
30155,30,155,2019,06,0,3533,43,0,0,0,0,3576,43,1
30157,30,157,2019,06,0,209,0,0,0,0,0,209,0,1
30158,30,158,2019,06,0,953,63,0,0,0,0,1016,63,1
30160,30,160,2019,06,0,4423,85,0,0,0,0,4508,85,1
30161,30,161,2019,06,0,1339,3,0,0,0,0,1342,3,1
30164,30,164,2019,06,0,443,0,0,0,0,0,443,0,1
30165,30,165,2019,06,0,0,1,0,0,0,0,1,1,1
30166,30,166,2019,06,0,33,0,0,0,0,0,33,0,1
30167,30,167,2019,06,0,276,0,0,0,0,0,276,0,1
30169,30,169,2019,06,0,771,0,0,0,0,0,771,0,1
30172,30,172,2019,06,0,334,0,0,0,0,0,334,0,1
30173,30,173,2019,06,0,1969,8,0,0,0,0,1977,8,1
30174,30,174,2019,06,4018,4984,39,0,0,0,0,9041,4057,2
30175,30,175,2019,06,4393,2763,7,0,0,0,0,7163,4400,2
30176,30,176,2019,06,0,242,0,0,0,0,0,242,0,1
30178,30,178,2019,06,772,816,0,0,0,0,0,1588,772,2
30181,30,181,2019,06,1184,676,0,0,0,0,0,1860,1184,2
30182,30,182,2019,06,0,129,2,0,0,0,0,131,2,2
30183,30,183,2019,06,1388,4067,5,0,0,0,0,5460,1393,2
30186,30,186,2019,06,0,375,0,0,0,0,0,375,0,1
30188,30,188,2019,06,0,128,0,0,0,0,0,128,0,1
30189,30,189,2019,06,11443,11769,1087,0,0,0,0,24299,12530,2
30191,30,191,2019,06,3229,1820,8,0,0,0,0,5057,3237,2
30192,30,192,2019,06,0,1465,163,0,0,0,0,1628,163,1
30193,30,193,2019,06,82456,37893,49591,0,0,0,0,169940,132047,3
30194,30,194,2019,06,0,107,36,0,0,0,0,143,36,1
30196,30,196,2019,06,0,1574,7,0,0,0,0,1581,7,1
30197,30,197,2019,06,0,156,0,0,0,0,0,156,0,1
30200,30,200,2019,06,0,145,0,0,0,0,0,145,0,1
30201,30,201,2019,06,0,771,43,0,0,0,0,814,43,1
30204,30,204,2019,06,0,5327,2,0,0,0,0,5329,2,1
30205,30,205,2019,06,0,746,0,0,0,0,0,746,0,1
30206,30,206,2019,06,2293,2135,625,0,0,0,0,5053,2918,2
30207,30,207,2019,06,1806,1557,5,0,0,0,0,3368,1811,2
30208,30,208,2019,06,1865,1413,1,0,0,0,0,3279,1866,2
30210,30,210,2019,06,0,159,0,0,0,0,0,159,0,1
30211,30,211,2019,06,720,2000,13,0,0,0,0,2733,733,2
31002,31,002,2019,06,0,370,0,0,0,0,0,370,0,1
31003,31,003,2019,06,0,146,0,0,0,0,0,146,0,1
31004,31,004,2019,06,0,110,0,0,0,0,0,110,0,1
31006,31,006,2019,06,370,78,0,0,0,0,0,448,370,2
31007,31,007,2019,06,0,174,0,0,0,0,0,174,0,1
31009,31,009,2019,06,0,5,0,0,0,0,0,5,0,1
31011,31,011,2019,06,0,206,0,0,0,0,0,206,0,1
31013,31,013,2019,06,0,208,854,0,0,0,0,1062,854,2
31019,31,019,2019,06,799,82,0,0,0,0,0,881,799,2
31020,31,020,2019,06,0,223,0,0,0,0,0,223,0,1
31026,31,026,2019,06,0,111,0,0,0,0,0,111,0,1
31027,31,027,2019,06,0,354,1,0,0,0,0,355,1,2
31029,31,029,2019,06,0,92,0,0,0,0,0,92,0,1
31032,31,032,2019,06,298,133,0,0,0,0,0,431,298,2
31033,31,033,2019,06,0,228,0,0,0,0,0,228,0,1
31035,31,035,2019,06,0,211,0,0,0,0,0,211,0,1
31038,31,038,2019,06,0,763,13,0,0,0,0,776,13,1
31040,31,040,2019,06,1049,499,0,0,0,0,0,1548,1049,2
31041,31,041,2019,06,0,1291,79,0,0,0,0,1370,79,2
31048,31,048,2019,06,0,372,0,0,0,0,0,372,0,1
31049,31,049,2019,06,0,0,0,0,0,0,0,0,0,1
31050,31,050,2019,06,98728,48773,81734,0,0,0,0,229235,180462,3
31052,31,052,2019,06,920,1205,1,0,0,0,0,2126,921,2
31053,31,053,2019,06,0,571,0,0,0,0,0,571,0,1
31056,31,056,2019,06,0,1899,3,0,0,0,0,1902,3,1
31057,31,057,2019,06,0,292,0,0,0,0,0,292,0,1
31058,31,058,2019,06,0,974,0,0,0,0,0,974,0,1
31059,31,059,2019,06,8901,2779,717,0,0,0,0,12397,9618,3
31061,31,061,2019,06,0,260,0,0,0,0,0,260,0,1
31066,31,066,2019,06,0,3,20,0,0,0,0,23,20,1
31076,31,076,2019,06,0,149,0,0,0,0,0,149,0,1
31079,31,079,2019,06,0,1686,0,0,0,0,0,1686,0,1
31080,31,080,2019,06,0,100,0,0,0,0,0,100,0,1
31082,31,082,2019,06,0,190,0,0,0,0,0,190,0,1
31083,31,083,2019,06,0,157,173,0,0,0,0,330,173,1
31084,31,084,2019,06,164,86,0,0,0,0,0,250,164,2
31085,31,085,2019,06,426,0,26,0,0,0,0,452,452,2
31089,31,089,2019,06,0,2480,31,0,0,0,0,2511,31,1
31091,31,091,2019,06,0,288,0,0,0,0,0,288,0,1
31093,31,093,2019,06,0,982,0,0,0,0,0,982,0,1
31096,31,096,2019,06,1462,3110,20,0,0,0,0,4592,1482,2
31098,31,098,2019,06,0,340,0,0,0,0,0,340,0,1
31100,31,100,2019,06,0,29,0,0,0,0,0,29,0,1
31101,31,101,2019,06,2263,739,1559,0,0,0,0,4561,3822,3
31102,31,102,2019,06,5184,3496,46,0,0,0,0,8726,5230,3
31105,31,105,2019,06,0,0,1,0,0,0,0,1,1,1
32001,32,001,2019,06,0,486,0,0,0,0,0,486,0,1
32003,32,003,2019,06,0,99,0,0,0,0,0,99,0,1
32004,32,004,2019,06,0,300,0,0,0,0,0,300,0,1
32005,32,005,2019,06,0,4258,100,0,0,0,0,4358,100,1
32006,32,006,2019,06,0,372,0,0,0,0,0,372,0,1
32007,32,007,2019,06,0,665,1,0,0,0,0,666,1,2
32008,32,008,2019,06,0,652,0,0,0,0,0,652,0,1
32009,32,009,2019,06,0,197,2,0,0,0,0,199,2,2
32010,32,010,2019,06,7287,11808,938,0,0,0,0,20033,8225,3
32011,32,011,2019,06,0,254,0,0,0,0,0,254,0,1
32014,32,014,2019,06,0,839,0,0,0,0,0,839,0,1
32016,32,016,2019,06,0,726,0,0,0,0,0,726,0,1
32017,32,017,2019,06,0,10024,3047,0,0,0,0,13071,3047,2
32018,32,018,2019,06,0,265,0,0,0,0,0,265,0,1
32019,32,019,2019,06,0,2522,0,0,0,0,0,2522,0,1
32020,32,020,2019,06,4268,4330,97,0,0,0,0,8695,4365,3
32022,32,022,2019,06,0,2110,0,0,0,0,0,2110,0,1
32023,32,023,2019,06,0,1753,0,0,0,0,0,1753,0,1
32024,32,024,2019,06,0,3350,0,0,0,0,0,3350,0,1
32025,32,025,2019,06,0,708,0,0,0,0,0,708,0,1
32026,32,026,2019,06,0,180,0,0,0,0,0,180,0,1
32029,32,029,2019,06,0,1461,1,0,0,0,0,1462,1,2
32030,32,030,2019,06,0,193,0,0,0,0,0,193,0,1
32031,32,031,2019,06,0,519,0,0,0,0,0,519,0,1
32032,32,032,2019,06,0,1220,4,0,0,0,0,1224,4,2
32033,32,033,2019,06,0,372,0,0,0,0,0,372,0,1
32034,32,034,2019,06,0,2200,1,0,0,0,0,2201,1,1
32035,32,035,2019,06,0,187,0,0,0,0,0,187,0,1
32036,32,036,2019,06,0,2175,1,0,0,0,0,2176,1,2
32037,32,037,2019,06,0,99,0,0,0,0,0,99,0,1
32038,32,038,2019,06,0,951,0,0,0,0,0,951,0,1
32039,32,039,2019,06,0,5713,30,0,0,0,0,5743,30,1
32040,32,040,2019,06,0,374,0,0,0,0,0,374,0,1
32042,32,042,2019,06,0,3615,2,0,0,0,0,3617,2,2
32044,32,044,2019,06,0,1106,0,0,0,0,0,1106,0,1
32045,32,045,2019,06,0,587,0,0,0,0,0,587,0,1
32046,32,046,2019,06,0,271,0,0,0,0,0,271,0,1
32047,32,047,2019,06,0,489,0,0,0,0,0,489,0,1
32048,32,048,2019,06,0,2480,0,0,0,0,0,2480,0,1
32049,32,049,2019,06,0,2225,0,0,0,0,0,2225,0,1
32050,32,050,2019,06,0,22,0,0,0,0,0,22,0,1
32051,32,051,2019,06,0,750,0,0,0,0,0,750,0,1
32052,32,052,2019,06,0,670,0,0,0,0,0,670,0,1
32053,32,053,2019,06,0,982,0,0,0,0,0,982,0,1
32054,32,054,2019,06,0,517,0,0,0,0,0,517,0,1
32055,32,055,2019,06,2098,1011,0,0,0,0,0,3109,2098,2
32056,32,056,2019,06,58801,10446,3443,0,0,0,0,72690,62244,4
32057,32,057,2019,06,0,1014,0,0,0,0,0,1014,0,1
32058,32,058,2019,06,0,199,2,0,0,0,0,201,2,2
